soonfy  soonfy
361°	brands
Vans	brands
范斯	brands
3M	brands
A.O.Smith	brands
Aape	brands
Acer	brands
Acfun	brands
Adidas	brands
Afu	brands
Agelocer	brands
Alcatel	brands
AlexanderWang	brands
Alpenliebe	brands
Aokang	brands
Aonafen	brands
Apple	brands
Aquair	brands
Armani	brands
Arrow	brands
Asics	brands
Asus	brands
Aucma	brands
Audio-Technica	brands
Aupres	brands
Aux	brands
Avene	brands
Balenciaga	brands
Balmain	brands
Basto	brands
BBK	brands
Beats	brands
Bejirog	brands
Benefit	brands
BenQ	brands
Bentley	brands
Benz	brands
Berliget	brands
Bilibili	brands
Binkada	brands
Bioderma	brands
Biotherm	brands
Biroe	brands
Blackberry	brands
Bmw	brands
Bosideng	brands
BottegaVeneta	brands
Bourjois	brands
Bowdor	brands
Braun	brands
Bull	brands
Burberry	brands
Bvlgari	brands
C&S	brands
Cadbury	brands
Cadillac	brands
CaliforniaBaby	brands
Caltrate	brands
CalvinKlein	brands
Camel	brands
Canca	brands
Carslan	brands
Cartier	brands
Casarte	brands
Casio	brands
Cat	brands
Caudalie	brands
Celine	brands
Certina	brands
Cetaphil	brands
Chando	brands
Chanel	brands
Changhong	brands
Changyu	brands
Chanzhiyun	brands
Charmzone	brands
Chiaus	brands
Chigo	brands
Chloe	brands
ChromeHearts	brands
Chunlan	brands
Clarins	brands
CleDePeau	brands
Clinique	brands
Coach	brands
CocaCola	brands
Cogi	brands
Colgate	brands
Converse	brands
Coolpad	brands
CosmeDecorte	brands
Courvoisier	brands
Crest	brands
Curel	brands
DancingWolves	brands
DanielWellington	brands
Daphne	brands
Darlie	brands
Davidoff	brands
Deerway	brands
Deli	brands
Dettol	brands
DHC	brands
Diesel	brands
Dior	brands
Discover	brands
Dita	brands
Dkny	brands
Dolce&Gabbana	brands
Donless	brands
Doov	brands
Dr.Hauschka	brands
Dr.Magic	brands
Dulux	brands
Durex	brands
Dyson	brands
Eaff	brands
Ebohr	brands
Ecovacs	brands
Elizabeth	brands
Esprit	brands
EsteeLauder	brands
Fairwhale	brands
Fendi	brands
Ferragamo	brands
Ferrari	brands
Fiyta	brands
Fjallraven	brands
Flyco	brands
ForestCabin	brands
Forever	brands
Fossil	brands
Franic	brands
Freeplus	brands
Fuanna	brands
Fuguiniao	brands
Fujitsu	brands
Gainliya	brands
Galanz	brands
Gatsby	brands
Geleiman	brands
GentleMonster	brands
Geya	brands
Gf	brands
Gialen	brands
Gillette	brands
Gionee	brands
Givenchy	brands
Google	brands
Gopas	brands
Gopro	brands
Grady	brands
Gree	brands
Guanqin	brands
Gucci	brands
Guerlain	brands
Gunner	brands
H&M	brands
Haier	brands
Hamilton	brands
Haotaitai	brands
Hengyuanxiang	brands
Heojeo	brands
Herborist	brands
Hermes	brands
Hershey’S	brands
Hisense	brands
Hitachi	brands
Holuns	brands
Hosjam	brands
Hotwind	brands
HP	brands
Hstyle	brands
HTC	brands
Huarun	brands
Huawei	brands
HugoBoss	brands
Hygienix	brands
Hyundai	brands
Inman	brands
Innisfree	brands
Inoherb	brands
Iqiyi	brands
Ivvi	brands
JackJones	brands
Jaguar	brands
Jeanswest	brands
Jeayou	brands
JoMalone	brands
Joeone	brands
Jsdun	brands
Junlebao	brands
Kangnai	brands
Kans	brands
Kashidun	brands
K-Boxing	brands
Kenzo	brands
Kfc	brands
Kiehl'S	brands
Kleenex	brands
Kodak	brands
Kohler	brands
Konka	brands
Kose	brands
Kotex	brands
LaChapelle	brands
LaMer	brands
LaRoche-Posay	brands
Ladycare	brands
LafeiManor	brands
Lamborghini	brands
Lancel	brands
Lancome	brands
LandRover	brands
Laneige	brands
Laurier	brands
Lay'S	brands
Lenovo	brands
Letdream	brands
Letv	brands
Levi'S	brands
Lg	brands
Lifebuoy	brands
Limn	brands
LiNing	brands
Lion	brands
Littleswan	brands
LiveYoung	brands
Lmz	brands
L'Occitane	brands
Loewe	brands
Logitech	brands
Lolo	brands
Longchamp	brands
Longines	brands
Loreal	brands
Lotte	brands
LouisVuitton	brands
Lv	brands
Macro	brands
Maden	brands
Mamonde	brands
MarcJacobs	brands
Marvin	brands
MaryKay	brands
Maserati	brands
MaskFamily1908	brands
Maxfutour	brands
MayFlower	brands
Maybelline	brands
Mcdonald'S	brands
Meifubao	brands
Meizu	brands
Mentholatum	brands
Metersbonwe	brands
Mexican	brands
Mi	brands
MichaelKors	brands
Micoe	brands
Microsoft	brands
Midea	brands
MissFace	brands
Missha	brands
Miumiu	brands
Mizhi	brands
Mizone	brands
Mk	brands
Monalisa	brands
Montagut	brands
Moschino	brands
Motorola	brands
Moutai	brands
Ms·She	brands
Muchi	brands
Muji	brands
Mumaren	brands
NanfangBlackSesame	brands
Nanjiren	brands
Nasentelophera	brands
NationalGeographic	brands
Nestle	brands
Neutrogena	brands
NewBalance	brands
Newman	brands
Nike	brands
Nikon	brands
Nivea	brands
Nixon	brands
Noah	brands
Nokia	brands
Nongfu	brands
Nubia	brands
Nuxe	brands
Ochirly	brands
Okamoto	brands
Olay	brands
Olipai	brands
Olivoila	brands
Olympus	brands
Omega	brands
Omo	brands
Only	brands
Oppein	brands
Opple	brands
Oppo	brands
Ora2	brands
Oral-B	brands
Origins	brands
Osm	brands
Ozark	brands
Ozing	brands
Panasonic	brands
Panda	brands
Pandora	brands
PatekPhilippe	brands
Peak	brands
Pepsi	brands
Peugeot	brands
Philips	brands
Pioneer	brands
Pisen	brands
Pizzahut	brands
Polaroid	brands
Polo	brands
Pond'S	brands
Porsche	brands
Poscer	brands
Povos	brands
Pps	brands
Pptv	brands
Prada	brands
Proya	brands
Puma	brands
Purcotton	brands
Pure＆Mild	brands
Qiaodan	brands
Qiku	brands
Quanu	brands
Raid	brands
RalphLauren	brands
RayBan	brands
Readboy	brands
Redbull	brands
Reebok	brands
Rejoice	brands
Rio	brands
Robam	brands
Rolex	brands
RoyalSalute	brands
Royalstar	brands
Runwe	brands
S.Deer	brands
Samsung	brands
Schneider	brands
Schwarzkopf	brands
Seagull	brands
Semir	brands
Sephora	brands
Septwolves	brands
Setir	brands
Seven	brands
Sevenfriday	brands
Shell	brands
Shooter	brands
ShuUemura	brands
Siemens	brands
Siontoss	brands
Sisley	brands
Skechers	brands
Sk-Ii	brands
Skinfood	brands
Skshu	brands
Skyworth	brands
Smartisan	brands
Snoopy	brands
Soaiy	brands
Sofy	brands
Sony	brands
Space7	brands
SpiderKing	brands
Sprite	brands
Staccato	brands
Subway	brands
Suntory	brands
Supor	brands
Supreme	brands
Swarovski	brands
Swatch	brands
SwissMilitary	brands
Swisswin	brands
TaTa	brands
TCL	brands
Teclast	brands
Tecsun	brands
Teintop	brands
Telsa	brands
TheBodyShop	brands
TheFaceShop	brands
Thtf	brands
TianWang	brands
Tide	brands
Tiffany	brands
Tiger	brands
Timex	brands
Tissot	brands
ToryBurch	brands
Tosot	brands
ToTo	brands
Triangle	brands
Trt	brands
Tudor	brands
UGG	brands
Underarmour	brands
Unisrobo	brands
Valentino	brands
Vancl	brands
Vatti	brands
Veadons	brands
Verawang	brands
Veromoda	brands
Versace	brands
Vichy	brands
VictoriaBeckham	brands
Vidalsassoon	brands
ViVo	brands
Volkswagen	brands
VS	brands
Watsons	brands
Wetherm	brands
Whaley	brands
Whoo后	brands
Wilon	brands
Winona	brands
Wqx	brands
Wuliangye	brands
Xinbailunlingpao	brands
Xtep	brands
Y3	brands
Yamaha	brands
Youngor	brands
Ysl	brands
Yuxiangfang	brands
YvesSaintLaurent	brands
Za	brands
Zara	brands
Zeiss	brands
Zhonghua	brands
Zhouhaya	brands
ZTE	brands
阿迪达斯	brands
阿尔卑斯	brands
阿尔卡特	brands
阿芙	brands
阿里影业	brands
阿玛尼	brands
阿斯顿马丁	brands
艾戈勒	brands
爱彼	brands
爱乐优	brands
爱马仕	brands
爱奇艺	brands
安安金纯	brands
安德玛	brands
安徽卫视	brands
安慕希	brands
奥迪	brands
奥康	brands
奥克斯	brands
奥林巴斯	brands
奥妙	brands
奥索卡	brands
澳柯玛	brands
澳娜芬	brands
巴宝莉	brands
巴尔曼	brands
巴黎世家	brands
白猫	brands
百草味	brands
百达翡丽	brands
百雀羚	brands
百事可乐	brands
百思图	brands
佰草集	brands
拜尔	brands
拜耳制药	brands
宝宝金水	brands
宝舵表	brands
宝格丽	brands
宝丽爵	brands
宝丽莱	brands
宝马	brands
宝珀	brands
保罗	brands
保时捷	brands
暴风tv	brands
暴风魔镜	brands
暴风体育	brands
暴风影音	brands
北极狐	brands
北极绒	brands
北京卫视	brands
北汽绅宝	brands
北汽新能源	brands
贝德玛	brands
贝玲妃	brands
倍舒特	brands
焙朗	brands
奔驰	brands
奔腾	brands
本田	brands
比度克	brands
比亚迪	brands
必胜客	brands
哔哩哔哩	brands
碧浪	brands
碧欧泉	brands
碧柔	brands
标致	brands
彪马	brands
别克	brands
宾卡达	brands
宾利	brands
波司登	brands
伯爵	brands
泊美	brands
泊泉雅	brands
博朗	brands
博纳	brands
步步高	brands
蔡司	brands
婵真	brands
婵之云	brands
馋嘴猴	brands
超威	brands
创佳	brands
创维	brands
锤子	brands
春纪	brands
春兰	brands
瓷肌	brands
达芙妮	brands
大松	brands
大卫杜夫	brands
大显	brands
大众	brands
戴森	brands
黛珂	brands
丹姿	brands
道奇	brands
稻草人	brands
稻花香	brands
得力	brands
德尔惠	brands
德国世家	brands
德生	brands
滴露	brands
迪奥	brands
迪塞尔	brands
迪塔	brands
帝舵	brands
蒂凡尼	brands
雕牌	brands
丁家宜	brands
东方卫视	brands
东风风度	brands
东风风行	brands
东风风神	brands
东芝	brands
读书郎	brands
杜嘉班纳	brands
杜蕾斯	brands
多芬	brands
多乐士	brands
朵唯	brands
鳄鱼	brands
法拉利	brands
法兰琳卡	brands
番茄台	brands
凡客诚品	brands
范思哲	brands
梵克雅宝	brands
飞科	brands
飞利浦	brands
飞亚达	brands
菲格拉慕	brands
菲拉格慕	brands
菲诗小铺	brands
菲亚特	brands
芬迪	brands
汾酒	brands
丰田	brands
锋达通	brands
芙丽芳丝	brands
福特	brands
富安娜	brands
富贵鸟	brands
富士	brands
富士通	brands
馥珮	brands
钙尔奇	brands
盖中盖	brands
冈本	brands
高柏诗	brands
高夫	brands
高洁丝	brands
高露洁	brands
高丝	brands
高田贤三	brands
高姿	brands
歌丽雅	brands
格兰仕	brands
格雷迪	brands
格雷曼	brands
格力	brands
格雅	brands
公牛	brands
古驰	brands
古井贡酒	brands
古琦	brands
谷歌	brands
冠琴	brands
光线传媒	brands
广汽传祺	brands
贵人鸟	brands
哈弗	brands
孩儿面	brands
海尔	brands
海飞丝	brands
海蓝之谜	brands
海鸥表	brands
海士爵	brands
海信	brands
韩都衣舍	brands
韩后	brands
韩束	brands
汉米尔顿	brands
汉密尔顿	brands
豪伦诗	brands
好记星	brands
好太太	brands
皓齿健	brands
皓乐齿	brands
赫恩	brands
黑莓	brands
恒大冰泉	brands
恒源祥	brands
红谷hongu	brands
红牛	brands
宏碁	brands
湖南卫视	brands
虎牌	brands
虎头虎脑	brands
护舒宝	brands
花印	brands
华帝	brands
华润漆	brands
华硕	brands
华为	brands
华谊	brands
皇冠曲奇	brands
皇家礼炮	brands
汇源	brands
惠普	brands
肌肤之钥	brands
肌研	brands
积家	brands
积优	brands
姬芮	brands
吉利汽车	brands
吉列	brands
纪梵希	brands
加多宝	brands
加州宝宝	brands
佳洁士	brands
佳能	brands
剑南春	brands
健力宝	brands
箭牌	brands
江诗丹顿	brands
江苏卫视	brands
娇兰	brands
娇兰佳人	brands
娇韵诗	brands
杰克琼斯	brands
杰尼亚	brands
杰士派	brands
洁柔	brands
洁婷	brands
洁云	brands
捷豹	brands
金稻	brands
金纺	brands
金立	brands
金六福	brands
金仕盾	brands
劲霸男装	brands
劲牌	brands
京润珍珠	brands
景田	brands
九牧王	brands
君乐宝	brands
卡地亚	brands
卡萨帝	brands
卡诗顿	brands
卡特	brands
卡西欧	brands
卡姿兰	brands
开拓者	brands
凯迪拉克	brands
康佳	brands
康奈	brands
珂润	brands
柯达	brands
科莱丽	brands
科勒	brands
科沃斯	brands
科颜氏	brands
壳牌	brands
可比克	brands
可口可乐	brands
可伶可俐	brands
克莱斯勒	brands
克罗心	brands
肯德基	brands
蔻驰	brands
酷开	brands
酷派	brands
快译通	brands
匡威	brands
拉菲	brands
拉夫劳伦	brands
拉夏贝尔	brands
来伊份	brands
徕卡	brands
兰博基尼	brands
兰蔻	brands
兰芝	brands
兰姿	brands
郎酒	brands
朗威	brands
浪琴	brands
浪莎	brands
劳力士	brands
老板	brands
乐而雅	brands
乐清堂	brands
乐事	brands
乐视	brands
乐视tv	brands
乐视手机	brands
乐视体育	brands
乐视影业	brands
乐天	brands
乐漾	brands
雷达	brands
雷克萨斯	brands
雷诺	brands
雷朋	brands
李宁	brands
李维斯	brands
理肤泉	brands
理光	brands
力帆	brands
立白	brands
立邦	brands
立顿	brands
立正	brands
荔枝台	brands
联想	brands
良品铺子	brands
两面针	brands
裂帛	brands
林肯汽车	brands
林清轩	brands
六个核桃	brands
珑骧	brands
隆力奇	brands
泸州老窖	brands
路虎	brands
路易威登	brands
露得清	brands
露露	brands
罗技	brands
罗意威	brands
洛娃	brands
骆驼	brands
绿箭	brands
绿伞	brands
妈妈壹选	brands
马登	brands
马可雅克布	brands
马克华菲	brands
马自达	brands
玛莎拉蒂	brands
麦当劳	brands
脉动	brands
满婷	brands
曼秀雷敦	brands
芒果tv	brands
芒果台	brands
茅台	brands
玫琳凯	brands
美宝莲	brands
美的	brands
美肤宝	brands
美即	brands
美加净	brands
美丽加芬	brands
美特斯邦威	brands
美图秀秀	brands
美赞臣	brands
美汁源	brands
魅可	brands
魅族	brands
蒙娜丽莎	brands
蒙牛	brands
梦特娇	brands
梦妆	brands
谜尚	brands
米智	brands
密斯坲驼	brands
妙巴黎	brands
妙洁	brands
明基	brands
膜法世家	brands
摩卡	brands
摩托罗拉	brands
摩纹	brands
魔法医生	brands
牧马人	brands
慕驰	brands
慕姗诗怡	brands
拿破仑	brands
耐克	brands
南方黑芝麻	brands
南极人	brands
妮维雅	brands
尼康	brands
尼克松	brands
牛栏山	brands
纽曼	brands
农夫	brands
努比亚	brands
诺基亚	brands
诺亚舟	brands
欧芙兰	brands
欧莱雅	brands
欧力派	brands
欧丽薇兰	brands
欧米茄	brands
欧派	brands
欧珀莱	brands
欧普照明	brands
欧诗漫	brands
欧时力	brands
欧舒丹	brands
欧树	brands
欧缇丽	brands
派克	brands
潘多拉	brands
潘婷	brands
旁氏	brands
匹克	brands
飘柔	brands
品胜	brands
苹果	brands
珀莱雅	brands
普拉达	brands
七彩云南	brands
七度空间	brands
七匹狼	brands
七喜	brands
柒牌	brands
奇酷	brands
奇瑞	brands
起亚	brands
千百度	brands
倩碧	brands
枪手	brands
乔丹	brands
清风	brands
清华同方	brands
清宜坊	brands
屈臣氏	brands
趣多多	brands
全棉时代	brands
全友	brands
雀巢	brands
雀氏	brands
热风	brands
日立	brands
荣事达	brands
荣威	brands
锐澳	brands
锐步	brands
瑞士军表	brands
瑞士十字	brands
赛百味	brands
三得利	brands
三点一刻	brands
三夫	brands
三角	brands
三棵树漆	brands
三菱	brands
三枪	brands
三星	brands
三雄极光	brands
三宅一生	brands
森马	brands
森太	brands
森田	brands
沙宣	brands
深圳卫视	brands
圣罗兰	brands
圣拓士	brands
狮王	brands
施巴	brands
施华蔻	brands
施华洛世奇	brands
施耐德	brands
史密斯	brands
史努比	brands
士力架	brands
狩猎者	brands
舒肤佳	brands
帅康	brands
水井坊	brands
水密码	brands
水星家纺	brands
水之蔻	brands
水之密语	brands
顺清柔	brands
丝芙兰	brands
丝塔芙	brands
思加图	brands
斯凯奇	brands
斯柯达	brands
斯沃琪	brands
四季沐歌	brands
松下	brands
搜狐	brands
苏泊尔	brands
苏菲	brands
索爱	brands
索尼	brands
太平鸟	brands
汰渍	brands
泰格豪雅	brands
谭木匠	brands
探索者	brands
特步	brands
特斯拉	brands
特种兵	brands
腾讯	brands
天美时	brands
天梭表	brands
天天快报	brands
天王表	brands
铁三角	brands
婷美小屋	brands
通用电气	brands
通用汽车	brands
同仁堂	brands
土豆网	brands
沱牌	brands
丸美	brands
万宝龙	brands
万达	brands
万国	brands
万家乐	brands
网易海淘	brands
旺旺	brands
威顿	brands
威洁士	brands
威龙	brands
微鲸	brands
微软	brands
薇诺娜	brands
薇姿	brands
卫宝	brands
温碧泉	brands
沃尔沃	brands
无印良品	brands
五粮春	brands
五粮液	brands
五月花	brands
西门子	brands
希思黎	brands
夏普	brands
现代汽车	brands
相宜本草	brands
香奈儿	brands
小红书	brands
小米	brands
小天鹅	brands
心相印	brands
新百伦	brands
新东方	brands
熊猫	brands
雪本诗	brands
雪碧	brands
雪佛兰	brands
雪花秀	brands
雪肌精	brands
雪铁龙	brands
雪铁纳	brands
雪完美	brands
迅雷	brands
雅戈尔	brands
雅丽洁	brands
雅马哈	brands
雅诗兰黛	brands
雅漾	brands
亚历山大王	brands
亚瑟士	brands
洋河	brands
养乐多	brands
一夫	brands
一加	brands
一叶子	brands
伊夫圣罗兰	brands
伊丽莎白雅顿	brands
伊利	brands
依波	brands
依泉	brands
怡口莲	brands
益达	brands
意尔康	brands
茵曼	brands
银鹭	brands
英菲尼迪	brands
英孚	brands
樱花卫浴	brands
永和豆浆	brands
优酷	brands
优思	brands
优衣库	brands
与狼共舞	brands
羽西	brands
雨果波士	brands
玉兰油	brands
郁美净	brands
御泥坊	brands
御香坊	brands
毓婷	brands
悦木之源	brands
悦诗风吟	brands
张裕	brands
长安轿车	brands
长安汽车	brands
长虹	brands
昭贵	brands
浙江卫视	brands
真维斯	brands
蜘蛛王	brands
植村秀	brands
志高	brands
中国移动	brands
中华	brands
中兴	brands
周黑鸭	brands
竹盐	brands
资生堂	brands
自然堂	brands
祖玛珑	brands
187美国社会档案	films
朗读者	films
触不到的TA	films
见字如面	films
跨界冰雪王	films
围炉音乐会	films
我不是明星	films
熟悉的味道	films
欢乐中国人	films
厉害我的歌	films
超强音浪	films
燃烧吧卡路里	films
新猛龙过江	films
明星志愿	films
向着幸福前进	films
爱in思谈	films
18爱不爱之怦然心动	films
1VS11	films
234说爱你	films
28岁未成年	films
38师机动队	films
818超女聊天室	films
A咖时尚	films
Big笑工坊唐唐神吐槽	films
Doctor异乡人	films
DreamKnight	films
FA主播粗事了	films
getitbeauty	films
Happy Together第三季	films
healer	films
Hello！女神	films
High5制霸青春	films
highschoolloveon	films
Hi男朋友	films
hotelking	films
KBeat中韩兄弟	films
killmehealme	films
OhMy思密达	films
Oh我的维纳斯	films
PMAM之美好侦探社	films
RunningMan	films
signal	films
THEK2	films
TheKellyShow	films
T台魔王	films
WAKOO！娱小姐第二季	films
WULI屋里变	films
WWE美式经典摔跤娱乐秀	films
W两个世界	films
XGirl	films
X玖少年频道	films
X战警	films
阿拉丁与神灯	films
阿里巴巴2：所罗门封印	films
哎呀我去之天龙八部	films
哎哟！辣么美	films
哎呦，表演系	films
艾伦秀第十四季	films
爱，来得刚好	films
爱宠大机密	films
爱的阶梯	films
爱的秘笈	films
爱的钟声	films
爱侃	films
爱来不来第一季	films
爱乐之城	films
爱丽和故事	films
爱丽丝梦游仙境	films
爱你万缕千丝	films
爱情保卫战	films
爱情不等式	films
爱情碟中谍	films
爱情公寓	films
爱情攻略	films
爱情进化论	films
爱情麻辣烫之情定终身	films
爱情配方	films
爱情是狗娘	films
爱情万万岁	films
爱情与友谊	films
爱情真善美	films
爱情终结战	films
爱情珠宝	films
爱人的谎言	films
爱上超模	films
爱上就会死的女人凤顺	films
爱上幼儿园	films
爱神箭	films
爱笑不笑	films
爱笑麻瓜秀	films
爱游我拍	films
爱在深秋	films
爱在星空下	films
俺娘田小草	films
暗黑者	films
暗杀	films
暗杀游戏	films
暗战危城	films
傲魂之活死人	films
傲慢与偏见	films
澳门风云	films
八卦鉴定事务所	films
八卦女人帮	films
巴霍巴利王	films
巴黎危机	films
扒神嗨评	films
芭莎大咖秀	films
爸爸带娃记	films
爸爸的3次婚礼	films
爸爸的假期	films
爸爸的木房子	films
爸爸父亲爹	films
爸爸回来了	films
爸爸快长大	films
爸爸请回答	films
爸爸去哪儿	films
白领拳击	films
白鹿原	films
白日杀机	films
白雪公主和三只小猪	films
白雪玩具屋	films
白衣校花与大长腿	films
白幽灵传奇之绝命逃亡	films
百变吧星君	films
百变五侠之我是大明星	films
百家乐翻天	films
百科新说	films
百年的新娘	films
百鸟朝凤	films
百思不得姐	films
百团大战	films
百万主播	films
摆渡人	films
拜拜啦肉肉	films
拜托了冰箱	films
拜托了衣橱	films
班淑传奇	films
办公室大爆炸	films
半熟少女	films
半妖倾城	films
包青天	films
包笑公堂	films
宝贝当家	films
宝贝你好	films
保姆的私密日记	films
报告老板	films
暴疯语	films
暴力街区	films
暴走大事件	films
暴走法条君	films
暴走神探	films
爆笑先森	films
北极大冒险	films
北京遇上西雅图	films
北平无战事	films
北上广不相信眼泪	films
北上广依然相信爱情	films
被劫持的爱情	films
奔爱	films
奔跑吧!裤衩	films
奔跑吧兄弟	films
奔跑吧兄弟电影	films
笨贼别跑	films
比基尼派对	films
比利·林恩的中场战事	films
笔仙诡影	films
笔仙撞碟仙	films
碧血书香梦	films
边城汉子	films
蝙蝠侠	films
蝙蝠侠大战超人	films
变形金刚	films
憋住不准笑	films
别担心！会红的	films
别叫我兄弟	films
别那么骄傲	films
别墅惊魂	films
宾虚	films
彬彬有理	films
冰川时代	films
冰河追凶	films
冰箱少女	films
冰雪大作战	films
冰雪女皇之冬日魔咒	films
冰血暴2	films
冰与火的青春	films
波达克	films
玻钻之争	films
搏击迷城	films
哺乳期的女人	films
不成问题的问题	films
不得不爱	films
不懂女人	films
不服来战	films
不可能完成的任务	films
不可思议的夏天	films
不可思异	films
不求回报	films
不是不想嫁	films
不速之客	films
不朽的时光	films
不朽法医	films
不要恋爱要结婚	films
不一样的偶像	films
布基兰	films
步步惊情	films
步步惊心	films
彩象岛的女孩	films
菜鸟阎王	films
藏地密码	films
藏尸恋	films
拆局专家	films
产科医生	films
唱响好儿歌	films
唱游天下	films
超霸花神	films
超级保镖	films
超级大英雄	films
超级歌单	films
超级快递	films
超级女声	films
超级演说家	films
超级幼儿园	films
超级育儿师	films
超级战队	films
超模学院	films
超脑48小时	films
超能查派	films
超能大星探	films
超能敢死队	films
超能荷尔蒙	films
超能快递侠	films
超能联盟	films
超能陆战队	films
超能太监	films
超能特务	films
超能写手	films
超人回来了	films
超人妈妈带娃记	films
超少年密码	films
超体	films
超星星学园	films
朝内81号	films
潮流教主	films
潮童天下	films
陈二狗的妖孽人生	films
陈翔六点半	films
城市猎人	films
赤道	films
赤裸惊魂	films
赤裸特工	films
冲锋车	films
冲上云霄	films
冲天火	films
出彩中国人	films
出发吧我们	films
出轨的女人	films
初恋女友俱乐部	films
初心房间	films
除妖传	films
楚汉传奇	films
穿警服的那些女孩儿	films
穿越吧厨房	films
穿越谜团	films
传承者	films
传奇大掌柜	films
传奇酒馆	films
传说的魔女	films
床上观戏	films
床上戏	films
床下有人3 	films
创客英雄会	films
创业123	films
春江英雄之秀才遇到兵	films
春妮的周末时光	films
纯洁心灵·逐梦演艺圈	films
纯熟意外	films
刺客列传	films
刺客聂隐娘	films
刺客信条	films
刺青海娘	films
刺猬小子之天生我刺	films
匆匆那年	films
从你的全世界路过	films
从天儿降	films
崔神驾到	films
淬火成钢	films
错点鸳鸯戏点鸳鸯	films
错配搭档	films
搭错车	films
搭讪大师	films
大刀记	films
大风水师	films
大汉情缘之云中歌	films
大好时光	films
大话蛇仙	films
大话西游	films
大会师	films
大嫁风尚	films
大猫儿追爱记	films
大梦西游	films
大闹天竺	films
大年初一立春	films
大牌对王牌	films
大牌驾到	films
大鹏嘚吧嘚	films
大秦帝国之崛起	films
大舜	films
大唐荣耀	films
大唐玄奘	films
大腕	films
大王小王	films
大卫贝肯之倒霉特工熊	films
大西洋帝国	films
大喜临门	films
大戏看北京	films
大侠黄飞鸿	films
大侠日天	films
大仙衙门	films
大笑江湖	films
大学生来了	films
大秧歌	films
大鱼海棠	films
呆呆计划	films
代理情人	films
带你去见TA	films
带你去探班	films
带着爸妈去旅行	films
待嫁老爸	films
戴流苏耳环的少女	films
单身男子	films
单身日记	films
单身战争	films
但丁密码	films
蛋计划	films
当家的女人	films
刀光枪影	films
刀剑缭乱	films
导火线	films
导火新闻线	films
岛囧	films
盗墓笔记	films
道士出山	films
道士下山	films
德州纸牌屋	films
的士速递	films
灯塔下的恋人	films
等你爱我	films
等一个人咖啡	films
低碳爱情	films
狄仁杰之四大天王	films
地雷英雄传	films
地雷战	films
地心营救	films
第22条婚规	films
第九个寡妇	films
第七子	films
第三种爱情	films
第五波	films
第一伞兵队	films
巅峰拍挡	films
垫底辣妹	films
屌丝男士	films
屌丝奇遇记	films
爹妈满院	films
谍影特工	films
谍影重重	films
碟仙诡谭2	films
碟仙之毕业照	films
碟中谍5	films
叮咯咙咚呛	films
定制幸福	films
东北剿匪记	films
东北抗日联军	films
东北往事	films
东方商人	films
东方眼	films
东方战场	films
东宫皇子	films
东江英雄刘黑仔	films
动漫英雄	films
动物好伙伴	films
动植物大战	films
都市怪谈	films
都市笑口组	films
都市妖奇谈	films
斗地主	films
斗龙战士之星印罗盘	films
斗鱼	films
豆娘	films
逗爱男女	films
逗比先生之逗比老爸	films
逗逗迪迪之美梦年年	films
逗鸟外传	films
逗鱼时刻炉石传说搞笑集锦	films
独立日	films
读心神探	films
赌城群英会	films
赌神	films
赌神归来	films
杜拉拉追婚记	films
渡灵人	films
锻刀	films
对风说爱你	films
对口型大作战	films
多情江山	films
哆啦A梦	films
夺宝传奇	films
夺路而逃	films
夺命枪火	films
恶毒梁欢秀	films
恶棍天使	films
恶灵之门	films
恶魔少爷别吻我	films
恶人报喜	films
饿了别叫妈之走火入模	films
儿子的战争	films
耳边疯	films
二十四小时	films
二胎时代	films
发条城市	films
法医秦明	films
法则前传	films
法证先锋	films
翻滚吧地球	films
翻身姐妹	films
反黑行动组	films
反击第一季	films
反恐特战队	films
反贪风暴	films
反转星球	films
犯罪心理	films
饭局的诱惑	films
范府大院	films
房事百科	films
放开我北鼻	films
放弃我抓紧我	films
飞刀又见飞刀	films
飞虎队	films
飞虎神鹰	films
飞虎雄师	films
飞买不可	films
飞天窑女	films
飞鹰艾迪	films
非常6+1	films
非常绑架	films
非常父子档	films
非常驾期	films
非常静距离	films
非常完美	films
非诚勿扰	films
非凡搭档	films
非凡匠客	films
非凡任务	films
非你莫属	films
非正式会谈	films
废柴特工	films
废柴兄弟	films
分歧者	films
分手的套路	films
愤怒的小鸟	films
风口青春	films
风云天地	films
封神传奇	films
封神道：哪吒闹海	films
封神英雄榜2	films
疯狂72小时	films
疯狂IP	films
疯狂丑小鸭	films
疯狂的冰箱	films
疯狂的丛林	films
疯狂的疯狂	films
疯狂的麦咭	films
疯狂动物城	films
疯狂试爱	films
疯狂天后	films
疯狂外星人	films
锋刃	films
锋味江湖之决战食神	films
蜂鸟	films
蜂鸟特攻	films
凤凰谷	films
夫妻游戏	films
伏击	films
芙蓉诀	films
福岛之恋	films
福根进城	films
釜山行	films
父亲的身份	films
父子魂斗罗	films
复仇	films
复仇者联盟	films
富贵逼人	films
丐帮传奇	films
盖世英雄	films
敢爱	films
钢铁骑士	films
港囧	films
杠上开花	films
高度戒备	films
高跟鞋先生	films
高科技少女喵	films
高品格单恋	films
搞笑档	films
搞笑蜘蛛侠	films
戈壁剿匪记	films
哥谭镇	films
歌从黄河来	films
歌手2017	films
歌手是谁	films
隔壁惊魂	films
隔离岛	films
跟着贝尔去冒险	films
跟着明道趣旅行	films
功夫婆媳	films
功夫四侠	films
功夫小蝇	films
功夫熊猫	films
功夫瑜伽	films
恭喜发财之谈钱说爱	films
孤单又灿烂的神	films
孤独的美食家	films
孤芳不自赏	films
孤雁	films
古惑镇激斗少年	films
古灵精探	films
古战场传奇	films
拐个皇帝回现代	films
怪咖啡	films
关八热话题	films
关中男人	films
观复锵锵	films
观音山	films
冠军的心	films
广告野疯狂	films
闺蜜	films
闺蜜嫁到	films
诡案	films
诡订餐	films
诡梦凶铃	films
诡替身	films
诡娃	films
诡新娘	films
诡眼	films
诡咒	films
鬼吹灯之精绝古城	films
鬼同你OT	films
贵族大盗	films
滚蛋吧肿瘤君	films
锅是铁	films
国产大英雄	films
国光帮帮忙	films
国家底线	films
国民美少女	films
国色天香	films
果宝特攻	films
果酱爱探班	films
过年好	films
还珠格格	films
海德、哲基尔与我	films
海底总动员	films
海蒂和爷爷	films
海上孟府	films
海洋奇缘	films
海洋之歌	films
骇故事之暗窗	films
韩伴FUN	films
韩国综艺最爆点	films
寒冬	films
寒山令	films
寒战	films
喊山	films
航海王之黄金城	films
好家伙	films
好声音正传	films
好先生	films
好笑头条君	films
好一个大家	films
合约男女	films
何以笙箫默	films
何以笙箫默电影	films
赫默尔	films
黑白星球	films
黑处有什么	films
黑洞	films
黑狐	films
黑色警报	films
黑社会	films
黑衣人	films
嘿孩子	films
嘿老头	films
横冲直撞好莱坞	films
红旗漫卷西风	films
红色护卫	films
红色青橄榄	films
红色通道	films
红星照耀中国	films
红颜容	films
鸿观第一季	films
后宫那些事儿	films
后海不是海	films
呼噜小精灵	films
狐影	films
糊涂县令郑板桥	films
虎爸潜伏记	films
虎符传奇	films
虎妈猫爸	films
花儿与少年	films
花红花火	films
花花花大作战	films
花旗少林	films
花千骨	films
花田喜事	films
花样厨神	films
花样江湖	films
花样姐姐	films
花样男团	films
花样排球	films
华丽上班族	films
华胥引之绝爱之城	films
华豫之门	films
画江湖之不良人	films
话梅糖	films
坏蛋必须死	films
坏姐姐之拆婚联盟	films
欢乐逗秀场	films
欢乐饭米粒儿	films
欢乐集结号	films
欢乐送	films
欢乐颂	films
欢乐喜剧人	films
欢天喜地对亲家	films
欢脱定律	films
欢喜密探	films
欢笑吧青春	films
环球梦游记	films
幻城	films
荒村凶间	films
荒村怨灵	films
荒野猎人	films
皇帝的新装之圣诞大明星	films
皇恩浩荡	films
黄飞鸿之英雄有梦	films
黄金100秒	films
黄金单身汉	films
黄金十二宫	films
黄金时代	films
黄小厨的春夏秋冬	films
谎言大爆炸	films
谎言西西里	films
灰姑娘	films
回来吧大叔	films
回声嘹亮	films
会痛的十七岁	films
彗星来的那一夜	films
混世高校	films
活该你单身	films
活力大冲关	films
活色生香	films
活着再见	films
火锅英雄	films
火海凌云	films
火枪手	films
火线反攻	films
火星救援	films
火星情报局	films
火影忍者	films
饥饿游戏	films
机器纪元	films
机器人帝国	films
机械师	films
鸡毛飞上天	films
鸡毛蒜皮	films
激战	films
吉祥宝宝之我是食神	films
吉祥天宝	films
吉星高照	films
极盗者	films
极度兽性	films
极度隐私	films
极品家丁	films
极品模王	films
极品女士	films
极品新娘	films
极速攻略	films
极速前进	films
极速之巅	films
极限挑战	films
极限挑战之皇家宝藏	films
记忆碎片	films
技行天下	films
济公传	films
既然青春留不住	films
继承者们	films
继父回家	films
寄生兽	films
寂寞空庭春欲晚	films
加速进行时	films
加油吧实习生	films
加油美少女	films
加油向未来	films
加油小当家	films
家和万事兴	films
家门的荣光	films
家庭幽默大赛	films
家庭幽默录像	films
家族之苦	films
假如我有超能力	films
假装看不见之电影大师	films
假装情侣	films
嫁个老公过日子	films
间谍同盟	films
监狱风云	films
煎饼侠	films
减法人生	films
见诡	films
见字如画	films
建党伟业	films
健忘村	films
箭士柳白猿	films
江湖龙虎斗	films
江湖麻辣烫之尊上驾到	films
江南灵异录之白云桥	films
将错就错	films
将婚姻进行到底	films
将界	films
僵尸归来	films
僵尸来了之伏魔夜	films
僵尸无极	films
僵尸至尊	films
降龙伏虎小济公	films
结婚前夜	films
结婚为什么	films
姐姐好饿	films
姐妹姐妹	films
姐妹兄弟	films
解救吾先生	films
解密	films
解忧公主	films
解忧买手店	films
借眼	films
今生只为还你的情	films
今晚80后脱口秀	films
今夜百乐门	films
金炳万的丛林法则	films
金蚕丝雨	films
金刚狼	films
金牌红娘	films
金牌调解	films
金水桥边	films
金星秀	films
锦绣未央	films
锦绣缘华丽冒险	films
进击吧闪电	films
劲舞青春	films
禁地之恐怖医院	films
禁区2015	films
京城81号	films
惊魂绣花鞋	films
惊天绑架团	films
惊天大逆转	films
惊天魔盗团	films
惊天破	films
惊喜旅程	films
精彩音乐汇	films
精灵旅社	films
精灵王座	films
警察夫人	films
警花与警犬	films
囧闻一箩筐	films
囧西游	films
九层妖塔	films
九九	films
九龙不败	films
九条命	films
九尾狐姐姐传	films
九星天辰诀	films
九州海上牧云记	films
九州天空城	films
酒国英雄之摆渡人	films
救姜刑警	films
就好这一口	films
就这么狐闹	films
狙击部队	films
局部第一季	films
剧透好声音	films
剧透之跑男	films
飓风营救	films
绝爱	films
绝地逃亡	films
绝对控制	films
绝命卦师	films
绝命后卫师	films
绝色武器	films
绝世高手	films
绝世撸神	films
绝世神偷	films
爵迹	films
卡酷动物园	films
开播乐	films
开普勒452b	films
开坛青春季	films
开心芒果	films
开心时刻与玩具介绍	films
凯利和玩具朋友们	films
凯文和游戏	films
铠甲勇士捕王	films
看见你的声音	films
看见味道的少女	films
看你往哪跑	films
康熙来了	films
康熙王朝	films
抗倭英雄戚继光	films
科技相对论	films
可凡倾听	films
克拉恋人	films
坑王驾到	films
恐怖爱情故事	films
恐怖笔记	films
恐怖将映	films
恐怖禁忌	films
恐怖快递	films
恐怖理发店	films
恐怖游泳馆	films
酷爸俏妈	films
跨界喜剧王	films
跨时代战书	films
快乐ELIFE	films
快乐大本营	films
快手枪手快枪手	films
筷仙 	films
狂爱造	films
狂怒	films
狂野飞车	films
窥情	films
昆虫总动员	films
昆仑决	films
昆仑阙之前世今生	films
蜡笔小新:梦境世界大突击	films
辣警霸王花	films
辣妈学院	films
辣手神探	films
来吧冠军	films
来自喵喵星的你	films
来自未来的史密特	films
来自星星的继承者们	films
来自星星的你	films
兰陵王妃	films
蓝色大海的传说	films
蓝色骨头	films
蓝色生死恋	films
篮球星播客	films
狼兵吼	films
狼图腾	films
琅琊榜	films
老爸向前冲	films
老公们的私房钱	films
老九门	films
老农民	films
老炮儿	films
老婆大人是80后	films
老师晚上好	films
老师也疯狂	films
老妖天使	films
乐俊凯	films
了不起的孩子	films
了不起的挑战	films
蕾女心经	films
泪洒女人花	films
梨园春	films
黎明决战	films
恋爱教父之三个坏家伙	films
恋爱中的城市	films
恋上播霸	films
良辰之屋	films
两个女人的战争	films
两生花	films
两天一夜	films
亮剑	films
聊斋新编	films
聊宅之超能姐姐大作战	films
烈日灼心	films
猎灵师	films
猎人公会之非你莫属	films
猎刃	films
猎神	films
猎鹰1949	films
邻家大贱谍	films
临界	films
灵魂摆渡	films
灵魂交易	films
灵界室友	films
灵偶契约	films
刘海戏金蟾	films
流感	films
流行之王	films
流泪花园	films
六颗子弹	films
六扇门	films
龙号机车	films
龙门镖局	films
龙器	films
龙拳小子	films
龙之战	films
龙珠	films
龙珠传奇之无间道	films
鲁滨逊漂流记	films
鲁豫有约	films
陆小凤与花满楼	films
陆垚知马俐	films
陆贞传奇	films
鹿鼎记	films
路边野餐	films
露水红颜	films
乱入乾坤	films
乱世丽人行	films
乱世书香	films
掠夺者	films
伦敦陷落	films
罗龙镇女人	films
罗马第一季	films
罗曼蒂克消亡史	films
萝莉侃剧	films
萝莉说美女	films
骡子和金子	films
裸婚之后	films
洛杉矶捣蛋计划	films
骆驼客	films
驴得水	films
侣行	films
绿箭侠	films
绿茵继承者	films
妈妈咪呀	films
妈妈是超人	films
妈妈向前冲	films
妈妈像花儿一样	films
麻辣变形计	films
麻辣芳邻	films
麻雀	films
马达加斯加的企鹅	films
马兰花开	films
马兰谣	films
马上天下	films
买家也疯狂	films
麦兜饭宝骑兵	films
麦兜响当当	films
满城尽带黄金甲	films
蔓蔓青萝	films
芒果捞星闻	films
猫脸老太太	films
猫田	films
茅山僵尸拳	films
冒牌卧底	films
没关系是爱情啊	films
玫瑰色的恋人们	films
湄公河大案	films
湄公河行动	films
每个人都有秘密	films
每天都换男朋友	films
每周神侃电视剧	films
美国处女	films
美国队长	films
美好的意外	films
美景之屋	films
美丽的秘密	films
美丽俏佳人	films
美女的诞生	films
美女敢死队	films
美女与极品	films
美女总裁与特种兵	films
美人季	films
美人如玉剑如虹	films
美人私房菜	films
美人为馅	films
美人鱼	films
美色时代	films
魅力野兽	films
萌星人de那些破事	films
蒙面唱将猜猜猜	films
蒙面歌王	films
猛龙特囧	films
梦想的声音	films
梦想改造家	films
梦想合伙人	films
梦魇惊魂	films
迷幻牛郎	films
迷乐英伦	films
迷途追凶	films
谜城	films
谜砂	films
米粒儿也疯狂	films
米佐的复仇	films
芈月传	films
秘密商店	films
秘术	films
蜜蜂少女队	films
蜜桃女孩	films
蜜月计划	films
蜜月酒店杀人事件	films
苗阜秀	films
灭罪师	films
名门劫	films
名侦探狄仁杰	films
名侦探猴赛雷	films
名侦探柯南	films
明白了妈	films
明若晓溪	films
明星大侦探	films
明星大制作	films
明星到我家	films
明星的诞生	films
明星伙伴	films
明星课程表	films
明星同乐会	films
鸣梁海战	films
命运规则	films
命中注定	films
模王小咖秀	films
摩尔庄园	films
魔发精灵	films
魔法逗士	films
魔宫魅影	films
魔兽	films
末日崩塌	films
末日浩劫	films
末日迷踪	films
末日使徒之灰烬	films
谋杀似水年华	films
牡丹仙子之皇帝昭曰	films
木兰妈妈	films
木星上行	films
幕味	films
暮光之瞳	films
哪一天我们会飞	films
那件疯狂的小事叫爱情	films
那年青春我们正好	films
那年我对你的承诺	films
那年夏天你去了哪里	films
那片星空那片海	films
那些年我们一起追的女孩	films
纳妾记	films
娜就这么说	films
奶爸的爱情生活	films
奶酪陷阱	films
奶奶说	films
耐撕秀	films
男人不可以穷	films
男人不醉	films
男神女神	films
男神女神颜习社	films
男神执事团	films
男生女生向前冲	films
南口1937	films
难忘金银滩	films
尼美快报	films
尼斯大冒险	films
你的名字	films
你好菜鸟	films
你好疯子	films
你好乔安	films
你好外星人	films
你会怎么做	films
你看起来很好吃	films
你们被包围了	films
你是我的姐妹	films
你是我的旅伴	films
你是我的眼睛	films
你为我着迷	films
你正常吗	films
逆光之恋	films
逆水寒	films
年代秀	films
年兽大作战	films
念念	films
柠檬初上	films
纽约纽约	films
怒火攻心	films
怒火英雄	films
怒江之战	films
暖心食堂	films
虐杀器官	films
诺亚方舟漂流记	films
女不强大天不容	films
女大学生宿舍	films
女帝	films
女汉子真爱公式	films
女怕嫁错郎	films
女朋友男朋友	films
女人不容易	films
女人的秘密	films
女人的武器	films
女人魂	films
女神爱手游	films
女神的选择	films
女神的战争	films
女神跟我走	films
女生日记之做决定事务所	films
女娲成长日记	films
女王的秘密	films
女王派对	films
女婿上门了	films
女医明妃传	films
女子监狱	films
女总裁的贴身高手	films
欧巴我入戏了	films
偶滴歌神啊	films
偶像就该酱婶	films
偶像来了	films
偶像猎手	films
偶像万万碎	films
啪啪顺风车	films
帕丁顿熊	films
帕帕帮	films
派对之王	films
跑男来了	films
泡菜帮	films
泡沫之夏	films
炮神	films
陪安东尼度过漫长岁月	films
佩小姐的奇幻城堡	films
配角逆袭事务所	films
怦·心跳	films
怦然星动	films
彭德怀元帅	films
霹雳囧花	films
匹诺曹	films
痞子猫	films
偏偏喜欢你	films
漂亮的李慧珍	films
漂亮朋友	films
贫穷富爸爸	films
乒乓侠	films
平淡生活	films
平凡的世界	films
屏里狐	films
婆媳的战国时代	films
破产姐妹	films
破风	films
破坏者	films
破晓	films
破晓的爱	films
葡萄园里的那男子	films
七龙珠	films
七日半	films
七星龙墓	films
七月半之恐怖宿舍	films
七月与安生	films
妻妾成群	films
妻子的谎言	films
凄灵室	films
奇幻森林	films
奇妙的朋友之萌爱	films
奇妙的时光之旅	films
奇妙世纪	films
奇葩大会	films
奇葩来了	films
奇葩说	films
奇葩兄妹	films
奇葩追梦	films
奇奇和悦悦的玩具	films
奇星记	films
奇异博士	films
奇异家庭	films
奇嘴八舌	films
起势摇滚	films
器灵	films
千方百计爱上你	films
千金归来	films
千金女佣	films
千金女贼	films
千里雷声万里闪	films
千门唐八将	films
千与千寻	films
前度	films
前目的地	films
前任攻略	films
前往世界的尽头	films
钱多多炼爱记	films
乾隆秘史	films
潜伏在黎明之前	films
潜行狙击	films
潜行者	films
枪侠	films
墙上的女人	films
且行且珍惜	films
亲艾的衣橱	films
亲爱的恩东啊	films
亲爱的翻译官	films
亲爱的公主病	films
亲密的搭档	films
亲情暖我心	films
亲向前冲	films
秦时明月	films
青春集结号	films
青春练习生	films
青春朋友圈	films
青春星主播	films
青春正能量	films
青岛往事	films
青年霍元甲	films
青丘狐传说	films
青蛙王国	films
青云志	films
清枫传奇	films
情比山高	films
情敌蜜月	films
情癫大圣	films
情花谷	films
情剑	films
情况不妙	films
情满雪阳花	films
情谜睡美人	films
请回答1988	films
球爱酒吧	films
球迷朋友圈	films
球球大作战手游	films
球舞青春	films
驱魔少年	films
圈里圈外	films
权力的游戏	films
全城通缉	films
全家好拍档	films
全球中文音乐榜上榜	films
全娱乐早扒点	films
全员躲猫猫	films
全员粉碎机	films
全员加速后	films
全员加速中	films
全员目击	films
全员小黑屋	films
群英会	films
燃烧吧少年	films
热土悲歌	films
热血	films
热血雷锋侠	films
热血长安	films
人工进化	films
人类清除计划	films
人民检察官	films
人偶总动员	films
人鱼校花	films
人在囧途	films
忍者神龟	films
任意依恋	films
日日煮	films
如果爱	films
如果可以这样爱	films
如果蜗牛有爱情	films
若是如此	films
撒娇女人最好命	films
萨利机长	films
三八线	films
三分钟看全员	films
三个奶爸	films
三个孬家伙	films
三个傻boy	films
三更车库	films
三国演义	films
三里屯的朋友圈	films
三毛从军记	films
三人行	films
三少爷的剑	films
三生三世十里桃花	films
三十定律	films
三时三餐	films
嫂子嫂子	films
色情男女	films
涩世纪传说	films
杀破狼	films
杀手乔	films
沙漠之心	films
沙僧日记	films
鲨滩	films
傻儿传奇之抗战到底	films
傻儿夫妻小神郎	films
傻根进城	films
山海经之赤影传说	films
山海经之山河图	films
山那边有匹马	films
山炮进城	films
杉杉来了	films
闪电侠	films
闪电侠第一季	films
闪婚之七天嫁给你	films
闪亮的爸爸	films
闪亮茗天	films
赏金猎人	films
上错花轿之三嫁奇缘	films
上海纪实	films
上海王	films
上流社会	films
少林问道	films
少林英雄	films
少林足球	films
少年巴比伦	films
少年班	films
少年频道	films
少年神探狄仁杰	films
少年四大名捕	films
少帅	films
舌尖上的新年	films
射雕英雄传	films
身心美丽说	films
绅士的品格	films
深爱食堂	films
深宫遗梦	films
深海浩劫	films
深井食堂	films
深夜前的五分钟	films
深宅1927	films
神雕侠侣	films
神盾局特工	films
神剧亮了	films
神秘家族	films
神秘世界历险记	films
神奇的孩子	films
神奇动物在哪里	films
神枪手	films
神犬奇兵	films
神犬小七	films
神兽金刚之青龙再现	films
神探包青天	films
神探狄仁杰	films
神探驾到	films
神探夏洛克	films
神偷奶爸	films
神战权力之眼 	films
生活大爆笑	films
生活大爆炸	films
生命缘	films
生死96小时	films
生死翻盘	films
生死连	films
圣斗士星矢	films
盛女为爱作战	films
盛先生的花儿	films
剩斗士的店	films
剩者为王	films
尸语者	films
失常	films
失孤	films
失落十三年	films
失眠男女	films
失心者	films
师父	films
师兄撞鬼	films
诗歌之王	films
十二道锋味	films
十二公民	films
十二生肖	films
十个连长一个班	films
十七岁	films
十全九美之真爱无双	films
十三亿分贝	films
十万个冷笑话	films
十五年等待候鸟	films
十英寸的英雄	films
十周嫁出去	films
十宗罪	films
石敢当之雄峙天东	films
时光缘	films
时尚爆米花	films
时尚巅峰	films
时尚江湖	films
识汝不识丁	films
实是球事	films
实习侠	films
食人岛	films
食在囧途	films
史料不及	films
使徒行者	films
士兵突击	films
示铃录	films
世纪战元	films
世界辣么大	films
世界青年说	films
世界上的另一个我	films
试睡员48小时	films
视知医学说	films
是！尚先生	films
室友一起宅	films
守护丽人	films
守护者之觉醒	films
守婚如玉	films
守卫者浮出水面	films
殊死七日	films
淑女涩男	films
淑女之家	films
赎罪门	films
蜀山战纪之剑侠传奇	films
鼠来宝	films
双程	films
双刺	films
双面心理师	films
双喜盈门	films
谁的青春不迷茫	films
谁的青春不热血	films
谁给我答案	films
谁还没点事	films
谁杀了潘巾莲	films
谁是大歌神	films
谁是你的菜	films
谁是幸存者	films
谁是终极英雄	films
水果宝贝之水果总动员	films
水浒学院	films
睡在我上铺的兄弟	films
说出我的世界	films
思春少妇	films
撕人订制	films
撕人定制	films
死神的假期	films
死亡游戏	films
死亡之谜	films
死亡之雪	films
四大萌捕	films
四大名助	films
四平青年之浩哥大战古惑仔	films
四手妙弹	films
怂人列传	films
搜神记	films
搜天下	films
苏染染追夫记	films
速度与激情	films
所谓娱乐	films
所以和黑粉结婚了	films
他来了请闭眼	films
他是龙	films
塔洛	films
踏破硝烟	films
太行山上	films
太空熊猫英雄归来	films
太平轮	films
太平洋战争	films
太太万岁	films
太阳的后裔	films
太阳河	films
太乙仙魔录之灵飞纪	films
太子妃升职记	films
泰囧	films
泰山归来	films
昙花梦	films
探灵档案	films
唐朝好男人	films
唐立淇占星周运	films
唐人街探案	films
唐唐脱口秀	films
溏心风暴	films
糖小姐探案集	films
躺飞男神	films
桃色迷局	films
桃色骗局	films
淘男姐妹	films
淘气爷孙	films
特工皇妃楚乔传	films
特工卡特	films
特警力量	films
特种兵之霹雳火	films
特种部队：眼镜蛇崛起	films
腾空的日子	films
替代者之情迷画皮	films
天才J	films
天才在左疯子在右	films
天方晏谈	films
天机谜	films
天将雄师	films
天降恶邻	films
天局	films
天籁之战	films
天亮之前	films
天龙八部	films
天魔异种	films
天生要完美	films
天师之九转轮回盘	films
天使的城	films
天使请吻我	films
天天把歌唱	films
天天神评论	films
天天向上	films
天天有喜	films
天下父母	films
天涯明月刀	films
天涯浴血	films
天眼	films
甜水谣	films
舔屏嘿嘿嘿	films
挑战不可能	films
挑战好声音	films
挑战者联盟	films
调皮王妃	films
贴身校花	films
铁道飞虎	films
铁核桃	films
铁血精英	films
铁血战狼	films
铁在烧	films
通灵神探	films
同城邂逅	films
同居损友	films
偷窥日记	films
头号惊喜	films
头号前妻	films
头脑特工队	films
头牌魔姬觉醒	films
透鲜滴星期天	films
屠魔战士	films
土豆娱乐快报	films
土豪520	films
吐槽大会	films
推拿	films
托马斯和朋友们	films
拖旅行箱的女人	films
脱单宝典	films
脱皮爸爸	films
脱贫大决战	films
脱身者	films
外公芳龄38	films
完美告白	films
完美假期	films
完美有多美	films
玩的就是艳遇	films
玩偶骑士	films
万万没想到	films
万物生长	films
汪汪队立大功第3季	films
王朝的女人杨贵妃	films
王大花的革命生涯	films
王牌逗王牌	films
王牌对王牌	films
王牌特工	films
网络犯罪调查	films
危城	films
危机大调查	films
危情别墅	films
危险关系	films
微爱之渐入佳境	films
微能力者	films
微视好声音	films
微微一笑很倾城	films
为梦想加速	films
为你而来	films
为她而战	films
维多利亚的秘密	films
伪装者	films
未择之路	films
味解之谜	films
味蕾敢旅行	films
温暖在身边	films
温州两家人	films
问题大了	films
我爱满堂彩	films
我爱男保姆	films
我不是潘金莲	films
我不是王毛	films
我不是妖怪	films
我从远方来	films
我的PS搭档	films
我的爱对你说	films
我的爱情撞上了战争	films
我的爱属于你	films
我的宝贝	films
我的超能男神	films
我的蠢萌老公	films
我的第二次初恋	films
我的二哥二嫂	films
我的个神啊	films
我的极品女神	films
我的抗战	films
我的辣妹保镖	films
我的老千生涯	films
我的老师是传奇	films
我的灵界男友	films
我的美女老师	films
我的男友不是人	films
我的男友和狗	films
我的朋友陈白露小姐	films
我的奇妙男友	films
我的青春道馆	films
我的青春期	films
我的少女时代	films
我的圣途	films
我的师父黑无常	films
我的特工爷爷	films
我的铁血金戈梦	films
我的同事都有病	films
我的媳妇是女王	films
我的校花妹妹	films
我的新野蛮女友	films
我的新衣	films
我的兄弟叫顺溜	films
我的岳父会武术	films
我的早更女友	films
我的战争	films
我独自生活	films
我和她的传奇情仇	films
我家有明星	films
我叫郝聪明	films
我看你有戏	films
我们15个	films
我们毕业的夏天	films
我们成为星星	films
我们诞生在中国	films
我们的丛林日记	films
我们的法则	films
我们的青春不怕疼	films
我们的挑战	films
我们的选择	films
我们结婚了	films
我们来了	films
我们十七岁	films
我们相爱吧	films
我们战斗吧	films
我亲爱的朋友们	films
我去上学啦	films
我是创始人	films
我是大美人	films
我是大明星	films
我是独角兽	films
我是杜拉拉	films
我是歌手	films
我是红军	films
我是联想王	films
我是路人甲	films
我是哪吒	films
我是男神	films
我是你的眼	films
我是女王	films
我是食神	films
我是谁2015	films
我是特种兵之霹雳火	films
我是先生	films
我是演说家	films
我是赵传奇	films
我是证人	films
我是直播歌手	films
我说的都是真的	films
我为宫狂	films
我为喜剧狂	films
我想和你唱	films
我要成为超级巨星	films
我要上春晚	films
我要上蒙面	films
我与你的光年距离	films
卧虎藏龙	films
乌龙特工	films
屋顶上的青春	films
无敌铁桥三	films
无间道	films
无间侦探	films
无贱道	films
无尽的爱	films
无赖汉	films
无力社团	films
无名者	films
无情都市	films
无声的证言	films
无双谱	films
无限挑战	films
无心法师	films
吴晓波频道	films
五女闹京城	films
五鼠闹东京	films
午夜计程车	films
午夜寻访录	films
武林风	films
武林探秘	films
武林外传	films
武媚娘传奇	films
武神赵子龙	films
悟空传	films
悟空圣诞奇遇记	films
西部世界	films
西风烈	films
西西弗斯的料理	films
西涯侠	films
西游伏妖篇	films
西游记之大闹天宫	films
西游记之大圣归来	films
西游记之女儿国	films
西游记之孙悟空三打白骨精	films
西游奇遇记	films
吸血鬼侦探	films
嘻哈白蛇传	films
嘻哈帝国	films
嘻哈四重奏	films
嬉戏魔法乐园	films
洗冤录	films
喜剧班的春天	films
喜剧大联盟	films
喜剧者联盟	films
喜剧总动员	films
喜乐长安	films
喜气洋洋小金莲	films
喜羊羊与灰太狼	films
侠盗联盟	films
侠探杰克	films
狎鸥亭白夜	films
下辈子还做我老爸	films
下一站婚姻	films
夏家三千金	films
夏洛特烦恼	films
夏日甜心	films
夏天十九岁的肖像	films
夏威夷之恋	films
夏有乔木雅望天堂	films
仙剑客栈	films
仙剑奇侠传	films
仙剑云之凡	films
仙侠剑	films
先锋之那时青春	films
咸鱼传奇	films
嫌疑人X的献身	films
陷入纯情	films
乡村爱情	films
相爱穿梭千年	films
香肠派对	films
香蕉打卡	films
响聊聊	films
想爱就爱	films
想明白了再结婚	films
向往的生活	films
像素大战	films
像小朵一样	films
消失爱人	films
消失的凶手	films
销魂杀机	films
小爸妈	films
小别离	films
小哥喂喂喂 	films
小黄人大眼萌	films
小鸡炖蘑菇	films
小蚂蚁之环球大冒险	films
小门神	films
小明和他的小伙伴们	films
小时代	films
小戏骨	films
小戏骨刘三姐	films
小熊的夏天	films
小野兽花店	films
小丈夫	films
小镇大法官	films
小镇风云	films
小主起来嗨	films
晓说	films
晓松奇谈	films
校花的贴身高手	films
校花攻略	films
校园疯骚史之舞动青春	films
校园篮球风云	films
笑傲江湖	films
笑大吧之每日搞笑	films
笑料炖包袱	films
笑林足球	films
笑星闯地球	films
邪恶力量	films
谢文东	films
心花路放	films
心里的声音	films
心理罪	films
心灵解码	films
心语阳光	films
辛巴达与美人鱼公主	films
新边城浪子	films
新步步惊心	films
新大头儿子小头爸爸	films
新东方神娃	films
新还珠格格	films
新济公活佛	films
新精武门	films
新老娘舅	films
新木偶奇遇记	films
新娘大作战	films
新女婿时代	films
新三味聊斋	films
新少林寺	films
新闻当事人	films
新嘻哈四重奏	films
新萧十一郎	films
新氧明星整形教室	films
信者无敌	films
星厨集结号	films
星厨驾到	films
星动亚洲	films
星光大道	films
星际穿越	films
星际迷航	films
星空中的潘朵拉	films
星球大战	films
星球大战外传	films
星球者联盟	films
星闻天下	films
星星的密室	films
星月私房话	films
星月童话	films
星座啪啪啪	films
刑警队长	films
刑警兄弟	films
幸福的味道	films
幸福归来	films
幸福来敲门	films
幸福又见彩虹	films
幸福账单	films
凶手还未睡	films
凶在其中	films
兄弟连	films
兄弟之北漂歌手	films
雄关漫道	films
熊出没	films
秀才遇到兵	films
秀丽江山之长歌行	films
徐老师讲故事	films
续命游戏	films
轩辕大帝	films
旋风少女	films
旋风十一人	films
旋风孝子	films
薛定谔的猫	films
学姐知道	films
学童进击之新生来袭	films
学院传说之三生三世桃花缘	films
学渣少年	films
雪豹	films
雪域雄鹰	films
血战到底之壮丁也是兵	films
血战钢锯岭	films
血战铜锣湾	films
血族	films
寻龙诀	films
寻秦记	films
寻找爱的冒险	films
寻找前世之旅	films
胭脂	films
严冬里的春天	films
言值大作战	films
颜值大战	films
养个孩子不容易	films
妖出长安	films
妖精别走	films
遥远的婚约	films
瑶山飞狐	films
野山鹰	films
叶问	films
夜半哭声	films
夜闯寡妇村	films
夜活儿	films
夜孔雀	films
夜魔附身	films
夜魔人	films
夜夜谈	films
夜莺	films
一步之遥	films
一个勺子	films
一家不说两家话	films
一家老小向前冲	films
一棵心中的许愿树	films
一路惊喜	films
一路逆风	films
一路上有你	films
一路顺疯	films
一路向前	films
一年级	films
一念天堂	films
一念向北	films
一诺倾情	films
一仆二主	films
一起创业吧	films
一起同过窗	films
一起长大	films
一千零一夜	films
一生一世合家欢	films
一声所爱大地飞歌	films
一条叫王子的狗	films
一万年以后	films
一屋赞客	films
一夜疯狂	films
一夜迷情	films
一站到底	films
一智千金	films
一周好莱坞	films
一转成双	films
医道	films
医馆笑传	films
壹起去旅行	films
移动迷宫	films
彝海结盟	films
蚁人	films
倚天屠龙记	films
艺术学院那些事儿	films
异能女友	films
异星战场	films
异性合租的往事	films
异镇	films
易见+	films
因为爱情有幸福	films
因为遇见你	films
阴阳先生	films
音乐大师课	films
音乐公开课	films
银行大劫案	films
隐藏的歌手	films
隐秘动机	films
英雄祭	films
婴灵	films
樱桃小丸子	films
萤火奇兵	films
映山红	films
硬骨头	films
拥抱星星的月亮	films
永不磨灭的番号	films
永无止境	films
永远恋爱真美	films
勇士之城	films
勇士之门	films
优酷牛人精选	films
优酷全明星	films
优酷全娱乐	films
优叻个秀	films
幽灵医院	films
幽默大玩家	films
邮差	films
遊戏规则	films
游击英雄	films
游侠	films
有颜有料	films
有一个地方只有我们知道	films
有种你爱我	films
又拐个皇帝回现代	films
又见一帘幽梦	films
又是吴海英	films
幼儿缘	films
于成龙	films
于无声处	films
余罪	films
娱乐大歌厅	films
娱乐乐翻天	films
娱乐猛回头	films
娱乐星天地	films
与星共舞	films
语文故事	films
玉海棠	films
育婴室	films
狱中惊魂	films
欲爱	films
欲望出租房	films
欲望都市	films
欲望画室	films
欲望森林	films
欲罪	films
遇见爱情的利先生	films
遇见王沥川	films
袁游	films
原来是你	films
圆梦合伙人	films
圆梦巨人	films
圆桌派	films
猿创世界之熊孩子部落	films
远的要命的爱情	films
怨灵地下室	films
约吧大明星	films
约会恋爱究竟是什么	films
约跑不能停	films
越囧	films
越淘越开心	films
越战越勇	films
云巅之上	films
云画的月光	films
云水怒	films
云中行走	films
再婚进行时	films
再见吧烦恼	films
再见老婆大人	films
再见瓦城	films
再见在也不见	films
在世界中心呼唤爱	films
咱们穿越吧	films
咱们结婚吧	films
咱们相爱吧	films
攒钱罗曼史	films
糟糠之妻俱乐部	films
择天记	films
宅女侦探桂香	films
宅人食堂	films
詹姆士的厨房	films
战火中的兄弟	films
战狼	films
战旗	films
战神传说	films
战时兄弟	films
张梁记	films
张震讲故事	films
章鱼大暴炸	films
长城	films
长江图	films
长沙保卫战	films
长在面包树上的女人	films
长征大会师	films
这里是宁夏	films
这一刻对你说	films
侦探洪吉童	films
真爱如血	films
真情帮帮帮	films
真相辩辩辩	films
真相禁区	films
真心英雄	films
真星话大冒险	films
真正男子汉	films
甄嬛传	films
甄志丙的奇幻旅程	films
枕边诡影	films
枕边有张脸	films
震撼一条龙	films
蒸发太平洋	films
整垮前女友	films
只因单身在一起	films
知青家庭	films
栀子花开	films
执念师	films
直播港澳台	films
职来职往	films
制作人	films
致命复活	films
致命怪谈	films
致青春	films
致我们终将到来的爱情	films
智取威虎山	films
智在说	films
智者无敌	films
中国超模	films
中国达人秀	films
中国冠军范	films
中国好歌曲	films
中国好男儿	films
中国好声音	films
中国惊奇先生	films
中国梦想秀	films
中国面孔	films
中国情歌汇	films
中国散伙人	films
中国少年派	films
中国诗词大会	films
中国式关系	films
中国式相亲	films
中国新歌声	films
中国新声代	films
中国刑警803	films
中国舆论场	films
中国之星	films
中韩梦之队	films
中韩时尚王	films
中华好故事	films
中华好民歌	films
中华好诗词	films
中华文明之美	films
终极教师	films
终极使命	films
终极一班	films
终极硬汉	films
终极游侠	films
终结者	films
钟馗伏魔	films
重返20岁	films
重返好声音	films
重返灵界	films
重生三国之刺杀张角	films
重生之名流巨星	films
周六夜现场	films
周末父母	films
侏罗纪公园	films
侏罗纪世界	films
诛三计	films
猪猪侠之英雄猪少年	films
主播真会玩	films
主君的太阳	films
煮妇神探	films
抓住彩虹的男人	films
转身说爱你	films
壮志凌云	films
追婚记	films
追击者	films
追梦在路上	films
追凶者也	films
捉迷藏	films
捉妖大队	films
捉妖记	films
自寻短荐	films
综艺IN事件	films
综艺策不停	films
综艺大爆炸	films
综艺大嘴巴	films
综艺哈哈秀	films
综艺喜乐汇	films
综艺最爆点	films
综艺最劲爆	films
走进大戏台	films
走近中国消防	films
组团儿上春晚	films
最爱是中华	films
最好的时光	films
最好的我们	films
最后的巫师猎人	films
最后一战	films
最后一张签证	films
最后证言	films
最佳爱情	films
最佳前男友	films
最佳情侣	films
最美的时候遇见你	films
最美和声	films
最美是你	films
最强大夫	films
最强大脑	films
最强女团	films
最强小孩	films
最强星战	films
最炫国剧风	films
罪恶黑名单	films
左耳	films
左手劈刀	films
左眼诡事	films
作战吧偶像	films
乘风破浪	films
大脑天竺	films
决战食神	films
游戏规则	films
极限特工	films
生化危机	films
情圣	films
太空旅客	films
欢乐好声音	films
一条狗的使命	films
降临	films
疯岳撬佳人	films
魔弦传说	films
了不起的菲丽西	films
乐高蝙蝠侠大电影	films
天空之眼	films
玩命直播	films
萤火骑兵	films
一万公里的约定	films
超能龙骑侠	films
心惊胆战	films
宋妍霏	stars
郭雪芙	stars
张倬闻	stars
罗云熙	stars
韩东君	stars
邢菲 	stars
陈瑶	stars
任嘉伦	stars
李宏毅	stars
赵予熙	stars
李宗霖	stars
白宇	stars
陈若轩	stars
黄一琳	stars
韩志硕	stars
迪丽热巴 	stars
张智尧 	stars
安悦溪	stars
黄梦莹	stars
祝绪丹	stars
代斯	stars
杨安琪 	stars
张赫	stars
甘婷婷 	stars
孙艺洲 	stars
麦迪娜	stars
朱泳腾 	stars
盛一伦 	stars
岳旸 	stars
杨旭文	stars
李一桐	stars
陈星旭	stars
孟子义	stars
迪玛希	stars
谭晶	stars
阿拉蕾	stars
李亦航	stars
尹正 	stars
董卿 	stars
王嘉尔	stars
董力 	stars
池子	stars
李诞	stars
范湉湉	stars
肖骁	stars
颜如晶	stars
姜思达	stars
艾力	stars
邱晨	stars
乔欣	stars
黄执中	stars
李林	stars
陈咏开	stars
陈铭	stars
董婧	stars
欧阳超	stars
贝尔格里尔斯 	stars
傅园慧	stars
姚明	stars
叶梓萱	stars
孙怡	stars
周深	stars
邓伦	stars
吴优	stars
代超	stars
张博	stars
宋威龙	stars
张雅钦	stars
陈秋实	stars
蒋梓乐	stars
晏紫东	stars
卢卓	stars
刘亦宸 	stars
李鹤 	stars
2NE1-YG	stars
2PMJun_K	stars
2PMNichkhun	stars
2PM灿盛	stars
2PM俊昊	stars
2PM祐荣	stars
2PM泽演	stars
4MINUTE	stars
AceOfAngels	stars
AdamLevine	stars
AFTERSCHOOL	stars
AJ張傑	stars
AKB48梅田彩佳	stars
AKB48秋元才加	stars
AKB48小林香菜	stars
all4beauttty	stars
aMEI_feat_阿密特	stars
Andy_Wachowski	stars
Andygaga801	stars
AND-艾莉兒Allie	stars
angelababy	stars
Apink	stars
AvrilLavigne	stars
B1A4	stars
B1A4_SANDEUL	stars
Babyjoe_n_Babygrace	stars
BARO	stars
BAZ_LUHRMANN	stars
beastdw012	stars
Beeeestdjdjdjdj	stars
Beyonce	stars
brettratner	stars
BritneySpearsOfficial	stars
BrunoMars	stars
bumkeykM	stars
by2	stars
chB1A4	stars
chucksuk	stars
CL_GZB	stars
CNBLUE	stars
Cosmax	stars
daraxxicn	stars
Donghai1015	stars
DSPKARA	stars
ediq	stars
ELLA	stars
Elsa_Pataky	stars
ElsaPataky	stars
EmWatson	stars
EXO-K	stars
EXO-M	stars
FandySu欢子	stars
Faye_FIR飛兒樂團	stars
Fensine王大花	stars
Finale楼	stars
FIR阿沁世界	stars
FollowJYP	stars
FTISLAND	stars
GameGyu88	stars
Gary	stars
GEEKxIIN_	stars
GOT7	stars
GOT7Official	stars
Grady关喆	stars
H2K罗维	stars
HAHA_QUAN	stars
HannahQuinlivan	stars
haohaohyuk	stars
Helen洪	stars
heybiblee	stars
heybiblee_official	stars
HITA	stars
hitRECordJoe	stars
HughJackman	stars
hyominnn00	stars
hyoyeon_gg	stars
hyukohhyuk	stars
IanSomerhalder_Official	stars
iKON	stars
IM-Lucas	stars
J.Y.Park	stars
Jade王璐	stars
JamesBlunt	stars
Janice衛蘭	stars
Jason_Mraz_Official	stars
JimParsons_Oh	stars
Jin_Akanishi_Official	stars
JIYEON2____	stars
JustinTimberlakeCN	stars
JYJcomeon	stars
KARA	stars
KatyPerry	stars
KellyClarksonCN	stars
KimChou	stars
KongHyoJin	stars
Ladybeardddddd	stars
Lana_Wachowski	stars
LaToyaJackson	stars
Leah童Dou	stars
Lee_G_Pace	stars
LeeByungHun0712	stars
LeePace_Husky	stars
LEESOOHYUK_OFFICIAL	stars
LIMYOONA90	stars
LinkinParkOfficial	stars
LOLLIPOP_F阿緯	stars
LOLLIPOP_F敖犬	stars
LOLLIPOP_F小煜	stars
LuuBrothers	stars
MaggieQ	stars
Maroon5	stars
Mayday瑪莎	stars
MCHOTDOG熱狗	stars
me2day	stars
MikeAngelo	stars
Mike隋	stars
Mini夏至	stars
missAMin	stars
missA霏	stars
monster怪獸	stars
Mpire	stars
Mpire_Official	stars
Mr__小李子	stars
Mr_凡先生	stars
MrGary2014	stars
mydeeryo	stars
M鹿M	stars
NaiWen寶貝	stars
Nana谈莉娜	stars
Nichkhun	stars
NicoleKidman_CN	stars
N-SONIC_OFFICIAL	stars
nuneworanuch	stars
OFFICIAL_AFTERSCHOOL	stars
officialbrettratner	stars
officialtomcruise	stars
Paul_Wesley_CN	stars
PaulWalker	stars
PaulWalkerCN	stars
Pete三姑丈	stars
PongNawat	stars
PopuLady-寶兒	stars
PopuLady-大元	stars
PopuLady-庭萱	stars
PopuLady-宇珊	stars
PSY_OPPA	stars
push_dj	stars
Qripretty_Original	stars
Rain	stars
RCArmitage	stars
real__pcyyyyy	stars
realbaroganatanatda	stars
RenaR任	stars
Rihanna	stars
RobertDowneyJr	stars
Rose泰国	stars
rsmparamount	stars
SamuelLJackson	stars
SandaraPark	stars
sandymandy	stars
SE7EN	stars
SelenaGomez_CN	stars
seohyun徐玄	stars
SEUNGRI	stars
SEUNGRI胜利-YG	stars
Shakira_Official	stars
Sj-special1004	stars
SNH48-陈观慧	stars
SNH48-陈思	stars
SNH48-戴萌	stars
SNH48--宫泽佐江	stars
SNH48-孔肖吟	stars
SNH48-李宇琪	stars
SNH48-莫寒	stars
SNH48-钱蓓婷	stars
SNH48-邱欣怡	stars
SNH48-吴哲晗	stars
SNH48-徐_晨辰	stars
SNH48-许佳琪	stars
SNH48-张语格	stars
SNH48-赵嘉敏	stars
Snow-Leee	stars
Soler夏氏兄弟	stars
sophia嘉寧	stars
Sophy汪汪	stars
SpeXial	stars
SpeXial-Teddy	stars
SpeXial-晨翔Simon	stars
SpeXial-宏正Wes	stars
SpeXial-偉晉Wayne	stars
SpeXial-以綸Riley	stars
SpeXial-子閎Sam	stars
Stephy邓丽欣	stars
SUPERJUNIOR	stars
SwaggyT-ao	stars
Sy__Jessica	stars
tablo	stars
tablochina	stars
TaioCruz	stars
TaioCruzCN	stars
taraej0729	stars
TaylorSwift	stars
TFBOYS	stars
TF乐队-王译锋	stars
therealMaggieQ	stars
TheRock_Johnson	stars
TheRZA	stars
Tom_Felton	stars
Tom_Tykwer	stars
TomFelton	stars
turbosun	stars
TVBS廖盈婷	stars
T徐浩	stars
UNIQ	stars
UNIQ_承衍	stars
UNIQ_圣柱	stars
UNIQ_汶翰	stars
UNIQ_一博	stars
UNIQ_艺轩	stars
veggieg	stars
VITAS	stars
VIXX	stars
WestLife	stars
WINNER	stars
WonderGirls惠林	stars
WonderGirls先艺	stars
wu世勋-EXO	stars
X邢昭林ZL	stars
Yesung110684	stars
YOOINNA_YGOFFICIAL	stars
YUNAN男男	stars
YURIKWON_GG	stars
Yurisa	stars
yurisa_chan	stars
阿德里安布劳迪	stars
阿朵	stars
阿尔法	stars
阿佳组合	stars
阿里郎	stars
阿沁	stars
阿筎那	stars
阿信	stars
阿雅	stars
阿孜古丽·热西提	stars
艾伦	stars
艾玛沃特森	stars
艾梦萌	stars
艾如	stars
艾薇儿	stars
爱戴Edell	stars
爱乐团	stars
爱新觉罗启星	stars
安迪沃卓斯基	stars
安钧璨	stars
安宁	stars
安七炫	stars
安雯	stars
安雅	stars
安以轩	stars
安熠格	stars
安又琪	stars
安宰贤	stars
安志杰	stars
昂睿	stars
敖子逸	stars
八家户村	stars
八两金	stars
巴图	stars
白百何	stars
白冰	stars
白恩	stars
白红标	stars
白卉子	stars
白敬亭	stars
白举纲	stars
白凯南	stars
白灵	stars
白铭健	stars
白庆琳	stars
白若溪	stars
白珊	stars
白威	stars
白先勇	stars
白歆惠	stars
白雪	stars
白永成	stars
白雲	stars
百克力	stars
柏邦妮	stars
柏智杰	stars
板野友美	stars
包贝尔	stars
包小柏	stars
保剑锋	stars
保罗韦斯利	stars
保罗沃克	stars
鲍蕾	stars
鲍天琦	stars
鲍小蕾同学	stars
北川瞳	stars
北京小妞媚儿	stars
贝聿成	stars
毕畅	stars
毕飞宇	stars
毕赣	stars
毕书尽	stars
畢書盡	stars
碧昂丝	stars
边伯贤	stars
边潇潇	stars
鞭鞭于白水	stars
波多野结衣	stars
博博婷儿	stars
卜康	stars
卜磊	stars
卜学亮	stars
布兰妮	stars
布鲁诺马尔斯	stars
才仁卓玛	stars
彩色旗子	stars
蔡淳佳	stars
蔡蝶	stars
蔡国庆	stars
蔡健雅	stars
蔡康永	stars
蔡琳	stars
蔡旻佑	stars
蔡明	stars
蔡少芬	stars
蔡诗芸	stars
蔡詩芸	stars
蔡书雅	stars
蔡文静	stars
蔡霞	stars
蔡徐坤	stars
蔡妍	stars
蔡一杰	stars
蔡一傑	stars
蔡一智	stars
蔡依林	stars
蔡宜达	stars
蔡芷紜	stars
蔡卓妍	stars
灿多	stars
仓木麻衣	stars
苍井空	stars
曺圭贤	stars
曹保平	stars
曹炳琨	stars
曹承衍	stars
曹格	stars
曹可凡	stars
曹克难	stars
曹磊	stars
曹璐	stars
曹卫宇	stars
曹文轩	stars
曹曦文	stars
曹轩宾	stars
曹颖	stars
曹永廉	stars
曹云金	stars
曹征	stars
草心	stars
岑洁仪	stars
岑潔儀	stars
岑丽香	stars
岑麗香香	stars
曾宝仪	stars
曾曾	stars
曾虹畅	stars
曾华倩	stars
曾華倩	stars
曾恺玹	stars
曾黎	stars
曾沛慈	stars
曾少主	stars
曾炜	stars
曾晓斌	stars
曾轶可	stars
曾志伟	stars
查可欣	stars
柴智屏	stars
常铖	stars
常静	stars
常远	stars
车善玗	stars
车胜元	stars
车晓	stars
车永莉	stars
辰亦儒	stars
陈柏霖	stars
陈宝国	stars
陈炳强	stars
陈冲	stars
陈楚河	stars
陈楚生	stars
陈道明	stars
陈德容	stars
陈德森	stars
陈德修	stars
陈都灵	stars
陈法拉	stars
陈法蓉	stars
陈钢	stars
陈观慧	stars
陈冠希	stars
陈国辉	stars
陈国坤	stars
陈汉典	stars
陈好	stars
陈昊	stars
陈浩民	stars
陈赫	stars
陈红	stars
陈奂仁	stars
陈焕昌	stars
陈辉	stars
陈慧娴	stars
陈佳妍	stars
陈嘉桦	stars
陈嘉上	stars
陈建斌	stars
陈建汉	stars
陈建州	stars
陈键锋	stars
陈洁	stars
陈洁仪	stars
陈军	stars
陈凯歌	stars
陈可辛	stars
陈坤	stars
陈乐基	stars
陈丽媛	stars
陈励志	stars
陈莉敏	stars
陈龙	stars
陈美琪	stars
陈美诗	stars
陈明真	stars
陈默	stars
陈牧扬	stars
陈慕	stars
陈乃荣	stars
陈佩斯	stars
陈绮贞	stars
陈乔恩	stars
陈燃	stars
陈山聪	stars
陈少琪	stars
陈十三	stars
陈姝	stars
陈数	stars
陈司翰	stars
陈思	stars
陈思诚	stars
陈思思	stars
陈思斯	stars
陈松伶	stars
陈廷嘉	stars
陈庭欣	stars
陈威翰	stars
陈维涵	stars
陈伟霆	stars
陈炜	stars
陈文茜	stars
陈希郡	stars
陈翔	stars
陈翔橙	stars
陈向熙	stars
陈小春	stars
陈晓	stars
陈晓柏	stars
陈晓东	stars
陈晓楠	stars
陈晓旭	stars
陈晓雪	stars
陈欣宜	stars
陈秀丽	stars
陈秀珠	stars
陈学冬	stars
陈雅伦	stars
陈妍希	stars
陈彦妃	stars
陈扬	stars
陈怡蓉	stars
陈奕	stars
陈奕迅	stars
陈逸宁	stars
陈意涵	stars
陈茵薇	stars
陈羽凡	stars
陈月末	stars
陈展鹏	stars
陈昭羽	stars
陈正道	stars
陈芷菁	stars
陈祉希	stars
陈志健	stars
陈志朋	stars
陈紫函	stars
陈自瑶	stars
陳柏霖	stars
陳德森	stars
陳法蓉	stars
陳冠希	stars
陳嘉桓	stars
陳鍵鋒	stars
陳莉敏	stars
陳明真	stars
陳綺貞	stars
陳山聰	stars
陳珊妮	stars
陳松伶	stars
陳庭欣	stars
陳煒	stars
陳小春	stars
陳秀珠	stars
陳雅倫	stars
陳妍希	stars
陳奕	stars
陳奕迅	stars
陳逸寧	stars
陳意涵	stars
陳茵媺	stars
陳樂基	stars
陳正道	stars
陳芷菁	stars
陳自瑤	stars
晨媛儿	stars
晨梓妍	stars
成龙	stars
成泰燊	stars
成毅	stars
成宥利	stars
程璧	stars
程耳	stars
程皓枫	stars
程可儿	stars
程青松	stars
程韦然	stars
程韋然	stars
程小东	stars
程野	stars
程媛媛	stars
程紫城	stars
池昌旭	stars
池晟	stars
池石镇	stars
池珍熙	stars
迟帅	stars
赤西仁	stars
冲田杏梨	stars
储小蕾	stars
淳于珊珊	stars
崔宝月	stars
崔健	stars
崔始源	stars
崔心心	stars
崔永元	stars
崔志佳	stars
大S	stars
大张伟	stars
大左	stars
代乐乐	stars
戴春荣	stars
戴娇倩	stars
戴军	stars
戴君竹	stars
戴立忍	stars
戴萌	stars
戴梦梦	stars
戴夢夢	stars
戴佩妮	stars
戴向宇	stars
单立文	stars
单薇	stars
單立文	stars
道晖芝	stars
邓超	stars
邓尘朵	stars
邓萃雯	stars
邓家佳	stars
邓健泓	stars
邓婕	stars
邓丽欣	stars
邓讴歌	stars
邓莎	stars
邓天晴	stars
邓颖芝	stars
邓智伟	stars
邓紫棋	stars
邓紫衣	stars
鄧萃雯	stars
鄧健泓	stars
鄧穎芝	stars
鄧紫棋	stars
狄龙	stars
狄易达	stars
狄易達	stars
迪克牛仔	stars
迪丽热巴	stars
丁程鑫	stars
丁当	stars
丁黑	stars
丁汇宇	stars
丁武	stars
丁武唐朝	stars
丁晓红	stars
丁一宇	stars
丁勇岱	stars
丁宇辰	stars
丁子峻	stars
东尼大木	stars
董成鹏	stars
董冬咚d	stars
董浩	stars
董洁	stars
董敏莉	stars
董晴	stars
董璇	stars
董子健	stars
窦靖童	stars
窦唯	stars
窦骁	stars
窦智孔	stars
杜波	stars
杜淳	stars
杜德伟	stars
杜德偉	stars
杜海涛	stars
杜江	stars
杜娟	stars
杜俊泽	stars
杜琪峰	stars
杜若溪	stars
杜天皓	stars
杜汶泽	stars
杜奕衡	stars
杜雨宸	stars
杜雨露	stars
杜自持	stars
渡边麻友	stars
段林希	stars
段鹏程	stars
段奕宏	stars
多妈7788	stars
朵朵Quinny	stars
恩静	stars
尔冬升	stars
爾冬陞	stars
二手玫瑰乐队	stars
二丫王悦	stars
樊锦霖	stars
樊蕊	stars
樊少皇	stars
反光镜乐队	stars
范冰冰	stars
范春霞	stars
范世錡	stars
范伟	stars
范玮琪	stars
范瑋琪	stars
范文芳	stars
范晓萱	stars
范逸臣	stars
方安娜	stars
方大同	stars
方珈悠	stars
方炯镔	stars
方力申	stars
方琼	stars
方文山	stars
方妍心	stars
方圆	stars
方中信	stars
房子斌	stars
房祖名	stars
飞儿	stars
飞儿乐团	stars
费翔	stars
冯璧晴	stars
冯德伦	stars
冯巩	stars
冯家妹	stars
冯粒	stars
冯绍峰	stars
冯殊	stars
冯文娟	stars
冯曦妤	stars
冯小刚	stars
冯远征	stars
凤小岳	stars
芙蓉姐姐	stars
符荷晴	stars
福山雅治	stars
付梦妮	stars
付辛博	stars
傅彪	stars
傅程鹏	stars
傅冲	stars
傅淼	stars
傅明宪	stars
傅明憲	stars
傅晓田	stars
傅艺伟	stars
富大龙	stars
嘎萌	stars
甘婷婷	stars
甘薇	stars
高峰	stars
高高	stars
高广泽	stars
高海寧	stars
高瀚宇	stars
高昊	stars
高虎	stars
高凌风	stars
高露	stars
高明骏	stars
高群书	stars
高仁	stars
高圣远	stars
高姝瑶	stars
高伟光	stars
高伟伦	stars
高希希	stars
高晓菲	stars
高晓攀	stars
高晓松	stars
高亚麟	stars
高洋	stars
高叶	stars
高以翔	stars
高圆圆	stars
高远	stars
高云翔	stars
高梓淇	stars
歌者森	stars
格桑	stars
葛布	stars
葛存壮	stars
葛天	stars
葛兆恩	stars
耿乐	stars
宫泽佐江	stars
龚蓓苾	stars
龚嘉欣	stars
龚琳娜	stars
龚钰祺	stars
巩汉林	stars
巩俐	stars
巩新亮	stars
贡米	stars
古川雄辉	stars
古巨基	stars
古力娜扎	stars
古丽扎尔	stars
古天乐	stars
古小筝	stars
古永锵	stars
谷德昭	stars
谷智鑫	stars
顾剑	stars
顾莉雅	stars
顾璇	stars
顾长卫	stars
关楚耀	stars
关锦鹏	stars
关礼杰	stars
关凌	stars
关少曾	stars
关婷娜	stars
关小悦	stars
关晓彤	stars
关悦	stars
关喆	stars
关之琳	stars
关智斌	stars
關楚耀	stars
關禮傑	stars
關智斌	stars
管虎	stars
管乐	stars
冠佑	stars
光良	stars
归亚蕾	stars
桂纶镁	stars
郭蔼明	stars
郭宝昌	stars
郭碧婷	stars
郭采洁	stars
郭达	stars
郭德纲	stars
郭冬临	stars
郭富城	stars
郭洪钧	stars
郭霁红	stars
郭家铭	stars
郭金	stars
郭晋安	stars
郭京飞	stars
郭敬明	stars
郭静	stars
郭可盈	stars
郭亮	stars
郭露文	stars
郭美美	stars
郭品超	stars
郭少芸	stars
郭涛	stars
郭羡妮	stars
郭晓东	stars
郭晓冬	stars
郭晓峰	stars
郭晓然	stars
郭晓婷	stars
郭鑫	stars
郭彥甫	stars
郭珍霓	stars
郭政鸿	stars
郭政鴻	stars
过齐鸣	stars
哈瓦娜呐	stars
海陆	stars
海鸣威	stars
海清	stars
海岩	stars
韩冰	stars
韩彩英	stars
韩丹彤	stars
韩栋	stars
韩庚	stars
韩国组合BEAST	stars
韩寒	stars
韩红	stars
韩马利	stars
韩乔生	stars
韩青	stars
韩三平	stars
韩童生	stars
韩雯雯	stars
韩熙庭	stars
韩星行程	stars
韩雪	stars
韩野	stars
韩雨芹	stars
韩智慧	stars
韓馬利	stars
郝柏杰	stars
郝蕾	stars
郝劭文	stars
郝云	stars
何傲儿	stars
何超莲	stars
何超仪	stars
何大为	stars
何方	stars
何炅	stars
何浩文	stars
何佳怡	stars
何洁	stars
何静	stars
何琳	stars
何曼婷	stars
何明翰	stars
何晴	stars
何庆魁	stars
何群	stars
何润东	stars
何赛飞	stars
何晟铭	stars
何穗	stars
何维健	stars
何彦霓	stars
何雁詩	stars
何政军	stars
何琢言	stars
和晶	stars
河东勋	stars
河莉秀	stars
河图	stars
贺刚	stars
贺军翔	stars
賀軍翔	stars
赫子铭	stars
黑木真二	stars
黑人建州	stars
恒洋	stars
红孩	stars
洪冰瑶	stars
洪辰	stars
洪都拉斯	stars
洪晃	stars
洪剑涛	stars
洪杰	stars
洪金宝	stars
洪启	stars
洪天明	stars
洪小铃	stars
洪欣	stars
洪永城	stars
鸿利	stars
侯宝林	stars
侯鸿亮	stars
侯京健	stars
侯克明	stars
侯堃	stars
侯梦瑶	stars
侯明昊	stars
侯佩岑	stars
侯耀华	stars
侯耀文	stars
侯勇	stars
后弦	stars
胡冰卿	stars
胡兵	stars
胡蝶	stars
胡定欣	stars
胡恩绮	stars
胡歌	stars
胡海泉	stars
胡静	stars
胡军	stars
胡可	stars
胡玫	stars
胡夏	stars
胡小禎	stars
胡杏儿	stars
胡彦斌	stars
胡杨林	stars
胡盈祯	stars
胡宇威	stars
胡紫微	stars
虎虎	stars
許常德	stars
許慧欣	stars
許茹芸	stars
許廷鏗	stars
华晨宇	stars
华少	stars
华子	stars
桓淼淼	stars
黄安	stars
黄百鸣	stars
黄渤	stars
黄灿灿	stars
黄灿盛	stars
黄鼎礼格	stars
黄鼎禮格	stars
黄贯中	stars
黄光熙	stars
黄海冰	stars
黄海波	stars
黄浩然	stars
黄嘉乐	stars
黄建新	stars
黄健翔	stars
黄景瑜	stars
黄靖伦	stars
黄俊鹏	stars
黄堃	stars
黄磊	stars
黄礼格	stars
黄立成	stars
黄龄	stars
黄曼	stars
黄明	stars
黄品源	stars
黄绮珊	stars
黄乔歆	stars
黄秋生	stars
黄日华	stars
黄少祺	stars
黄圣依	stars
黄诗佳	stars
黄维德	stars
黄伟晋	stars
黄西	stars
黄小琥	stars
黄小蕾	stars
黄晓明	stars
黄轩	stars
黄雅莉	stars
黄以娜	stars
黄义达	stars
黄奕	stars
黄英	stars
黄韵玲	stars
黄长兴	stars
黄征	stars
黄正音	stars
黄志忠	stars
黄智雯	stars
黄智贤	stars
黄子韬	stars
黄宗泽	stars
黃長興	stars
黃芳雯	stars
黃海波	stars
黃浩然	stars
黃嘉千	stars
黃喬歆	stars
黃日華	stars
黃少祺	stars
黃又南	stars
黃智雯	stars
黃智賢	stars
黃子佼	stars
惠林	stars
惠小白	stars
惠英红	stars
惠英紅	stars
霍建华	stars
霍思燕	stars
霍政谚	stars
吉古	stars
吉杰	stars
吉克隽逸	stars
吉姆帕森斯	stars
吉泽明步	stars
纪春	stars
纪佳松	stars
纪茹璟	stars
纪英男	stars
纪姿含	stars
季晨	stars
季冠霖	stars
季肖冰	stars
嘉桦ella	stars
贾登史密斯	stars
贾静雯	stars
贾玲	stars
贾乃亮	stars
贾青	stars
贾斯汀汀布莱克	stars
贾晓晨	stars
贾一平	stars
贾媛媛	stars
贾樟柯	stars
贾宗超	stars
駱胤鳴	stars
菅纫姿	stars
菅韧姿	stars
江红	stars
江蕙	stars
江铠同	stars
江美琪	stars
江奇霖	stars
江珊	stars
江淑娜	stars
江疏影	stars
江涛	stars
江一燕	stars
江映蓉	stars
江语晨	stars
江祖平	stars
姜潮	stars
姜河那	stars
姜宏波	stars
姜鸿	stars
姜昆	stars
姜丽文	stars
姜敏赫	stars
姜鹏	stars
姜文	stars
姜文杰	stars
姜武	stars
姜熙健	stars
姜育恒	stars
蒋家旻	stars
蒋劲夫	stars
蒋梦婕	stars
蒋勤勤	stars
蒋雯丽	stars
蒋小涵	stars
蒋欣	stars
蒋雅文	stars
蒋依杉	stars
蒋依依	stars
蒋毅	stars
蒋中一	stars
蔣家旻	stars
蔣雅文	stars
焦恩俊	stars
焦晃	stars
焦俊艳	stars
杰森玛耶兹	stars
解惠清	stars
金朝晖	stars
金晨	stars
金城武	stars
金东硕	stars
金恩圣	stars
金丰	stars
金光民	stars
金基范	stars
金俊浩	stars
金俊秀	stars
金峻秀	stars
金玫玫	stars
金美儿	stars
金铭	stars
金培达	stars
金巧巧	stars
金赛纶	stars
金莎	stars
金善伊	stars
金圣柱	stars
金士杰	stars
金世佳	stars
金素恩	stars
金素妍	stars
金泰希	stars
金桐俊	stars
金希澈	stars
金贤重	stars
金星	stars
金秀贤	stars
金宣儿	stars
金依萌	stars
金英光	stars
金宇彬	stars
金裕贞	stars
金在中	stars
金兆钧	stars
金桢勋	stars
金志文	stars
金钟国	stars
金子乔	stars
晋松	stars
靳东	stars
京叶	stars
经超	stars
菁玮	stars
菁瑋	stars
井柏然	stars
景甜	stars
敬一丹	stars
玖月奇迹	stars
酒井法子	stars
鞠婧祎	stars
菊十一画	stars
巨石强森	stars
凯蒂佩里	stars
凯莉克莱森	stars
阚清子	stars
康杰	stars
康磊	stars
柯蓝	stars
柯有伦	stars
柯有倫	stars
柯震东	stars
柯震東	stars
孔垂楠	stars
孔嘉欢	stars
孔连顺	stars
孔琳	stars
孔令奇	stars
孔千千	stars
孔维	stars
孔肖吟	stars
孔小铭	stars
孔孝真	stars
寇乃馨	stars
寇振海	stars
昆凌	stars
拉娜沃卓斯基	stars
赖水清	stars
賴雅妍	stars
兰莺儿	stars
蓝博豪	stars
蓝心湄	stars
蓝燕	stars
蓝奕邦	stars
蓝盈莹	stars
蓝正龙	stars
斓曦	stars
藍波	stars
藍心湄	stars
藍正龍	stars
郎国任	stars
郎永淳	stars
浪人拾肆	stars
劳春燕	stars
老狼	stars
乐嘉	stars
乐瞳	stars
雷佳音	stars
雷杰	stars
雷恪生	stars
雷蒙	stars
雷诺儿叔叔	stars
蕾哈娜	stars
黎明	stars
黎耀祥	stars
黎一萱	stars
黎姿	stars
李艾	stars
李保田	stars
李滨	stars
李冰冰	stars
李秉宪	stars
李炳辰	stars
李彩桦	stars
李晨	stars
李晨浩	stars
李呈媛	stars
李承鹏	stars
李纯	stars
李丹阳	stars
李东海	stars
李东翰	stars
李东健	stars
李东霖	stars
李东学	stars
李多海	stars
李方丁	stars
李飞	stars
李菲	stars
李菲儿	stars
李恭	stars
李光洁	stars
李光洙	stars
李国修	stars
李國修	stars
李海娜	stars
李好	stars
李昊臻	stars
李婳	stars
李佳	stars
李佳航	stars
李佳薇	stars
李佳璇	stars
李家成	stars
李嘉欣	stars
李建复	stars
李健	stars
李解	stars
李进荣	stars
李景儿	stars
李静	stars
李俊昊	stars
李克勤	stars
李李仁	stars
李立	stars
李立群	stars
李琳	stars
李玲玉	stars
李龙滨	stars
李曼	stars
李茂	stars
李美琪	stars
李岷城	stars
李敏镐	stars
李明珠	stars
李乃文	stars
李念	stars
李佩斯	stars
李琦	stars
李起光	stars
李沁	stars
李秋泽	stars
李泉	stars
李荣浩	stars
李锐	stars
李珊珊	stars
李少红	stars
李昇炫	stars
李圣杰	stars
李晟	stars
李施嬅	stars
李世鹏	stars
李舜	stars
李思欣	stars
李斯丹妮	stars
李斯羽	stars
李偲菘	stars
李泰焕	stars
李泰兰	stars
李缇娜	stars
李緹娜	stars
李亭哲	stars
李威	stars
李维嘉	stars
李炜	stars
李文启	stars
李汶翰	stars
李溪芮	stars
李先镐	stars
李贤宰	stars
李相烨	stars
李相燁	stars
李湘	stars
李响	stars
李霄云	stars
李小璐	stars
李小萌	stars
李小冉	stars
李孝利	stars
李心艾	stars
李心草	stars
李心洁	stars
李昕芸	stars
李欣聪	stars
李欣汝	stars
李鑫雨	stars
李玹雨	stars
李雪健	stars
李雅男	stars
李亚男	stars
李亚鹏	stars
李妍锡	stars
李颜汐	stars
李艳	stars
李依晓	stars
李艺彤	stars
李易峰	stars
李易祥	stars
李逸朗	stars
李翊寧	stars
李幼斌	stars
李宇春	stars
李宇琪	stars
李雨奚	stars
李玉刚	stars
李玉玺	stars
李源根	stars
李岳	stars
李悦溪	stars
李云迪	stars
李韵歌	stars
李蘊	stars
李泽锋	stars
李贞贤	stars
李桢航	stars
李正信	stars
李治廷	stars
李智楠	stars
李钟硕	stars
李鍾碩	stars
李洙赫	stars
李准基	stars
李卓霖	stars
李子峰	stars
李宗翰	stars
李宗盛	stars
李宗泫	stars
理查德阿米蒂奇	stars
理麒	stars
厉娜	stars
利晴天	stars
利特	stars
俪媛	stars
连晨翔	stars
连凯	stars
连诗雅	stars
連詩雅	stars
练束梅	stars
梁爱琪	stars
梁柏坚	stars
梁栢堅	stars
梁朝伟	stars
梁朝偉	stars
梁大维	stars
梁枫	stars
梁冠华	stars
梁汉文	stars
梁欢	stars
梁家辉	stars
梁家仁	stars
梁靖琪	stars
梁静	stars
梁静茹	stars
梁镜珂	stars
梁烈唯	stars
梁翘柏	stars
梁文音	stars
梁言	stars
梁耀燮	stars
梁毅苗	stars
梁咏琪	stars
梁詠琪	stars
梁雨恩	stars
廖凡	stars
廖健	stars
廖京生	stars
廖景萱	stars
廖俊杰	stars
廖盈婷	stars
廖羽翘	stars
廖允杰	stars
林采欣	stars
林超贤	stars
林芳兵	stars
林更新	stars
林继东	stars
林嘉欣	stars
林江国	stars
林静	stars
林俊杰	stars
林肯公园	stars
林妙可	stars
林鹏	stars
林青霞	stars
林芮西	stars
林瑞阳	stars
林弯弯	stars
林玮婕	stars
林瑋婕	stars
林夕	stars
林溪涵	stars
林熙蕾	stars
林夏薇	stars
林香蘭	stars
林湘萍	stars
林晓培	stars
林心如	stars
林欣彤	stars
林雪	stars
林依晨	stars
林依轮	stars
林忆莲	stars
林盈臻	stars
林颖彤	stars
林頴彤	stars
林永健	stars
林宥嘉	stars
林宇中	stars
林育群	stars
林允	stars
林允儿	stars
林志玲	stars
林志炫	stars
林志颖	stars
林智贤	stars
林智賢	stars
林子聪	stars
林子闳	stars
玲花	stars
铃木亚美	stars
凌晗	stars
凌潇肃	stars
刘爱金	stars
刘蓓	stars
刘灿	stars
刘潮	stars
刘承俊	stars
刘春	stars
刘丛丹	stars
刘德华	stars
刘冬沁	stars
刘朵朵	stars
刘恩佑	stars
刘芳毓	stars
刘菲	stars
刘刚	stars
刘耕宏	stars
刘冠麟	stars
刘冠翔	stars
刘昊然	stars
刘浩龙	stars
刘桦	stars
刘欢	stars
刘济恺	stars
刘家凯	stars
刘家瑞	stars
刘嘉玲	stars
刘俊麟	stars
刘峻纬	stars
刘恺威	stars
刘力扬	stars
刘立	stars
刘美含	stars
刘萌萌	stars
刘敏	stars
刘敏涛	stars
刘明湘	stars
刘娜萍	stars
刘品言	stars
刘骐	stars
刘芊含	stars
刘倩	stars
刘青云	stars
刘然	stars
刘仁娜	stars
刘芮麟	stars
刘瑞琪	stars
刘若英	stars
刘诗诗	stars
刘思彤	stars
刘思希	stars
刘松仁	stars
刘涛	stars
刘天佐	stars
刘亭作	stars
刘庭羽	stars
刘彤	stars
刘威葳	stars
刘伟	stars
刘伟强	stars
刘雯	stars
刘惜君	stars
刘宪华	stars
刘小锋	stars
刘小唯	stars
刘晓庆	stars
刘晓晔	stars
刘心悠	stars
刘忻	stars
刘鑫	stars
刘序浩	stars
刘学义	stars
刘循子墨	stars
刘雅瑟	stars
刘洋	stars
刘晔	stars
刘烨	stars
刘一含	stars
刘仪伟	stars
刘钇彤	stars
刘亦菲	stars
刘奕君	stars
刘雨柔	stars
刘雨欣	stars
刘雨鑫	stars
刘玉翠	stars
刘媛媛	stars
刘芸	stars
刘长德	stars
刘镇伟	stars
刘志宏	stars
刘智扬	stars
刘洲成	stars
刘孜	stars
刘梓豪	stars
刘梓妍	stars
劉畊宏	stars
劉冠麟	stars
劉家凱	stars
劉嘉玲	stars
劉品言	stars
劉思希	stars
劉松仁	stars
劉心悠	stars
劉序浩	stars
劉雨柔	stars
柳荷娜	stars
柳岩	stars
柳云龙	stars
六朝总督	stars
六小龄童	stars
龙飞龙泽	stars
龙俊亨	stars
泷泽萝拉	stars
陇尚梦	stars
娄烨	stars
娄艺潇	stars
卢庚戌	stars
卢广仲	stars
卢洁云	stars
卢凯彤	stars
卢小娟	stars
卢星宇	stars
卢正雨	stars
芦芳生	stars
盧凱彤	stars
鲁健	stars
鲁敏宇	stars
鲁诺	stars
陆川	stars
陆家小贝儿	stars
陆可	stars
陆翊	stars
陆毅	stars
陆雨萱	stars
陆昱霖	stars
鹿晗	stars
路晨	stars
路一鸣	stars
罗大佑	stars
罗海琼	stars
罗弘证	stars
罗家英	stars
罗嘉良	stars
罗晋	stars
罗钧满	stars
罗霖	stars
罗美玲	stars
罗维	stars
罗文裕	stars
罗熙杰	stars
罗玉凤	stars
罗志祥	stars
罗中旭	stars
罗仲谦	stars
羅鈞滿	stars
羅美玲	stars
羅文裕	stars
羅志祥	stars
羅仲謙	stars
骆达华	stars
骆新	stars
骆胤鸣	stars
闾丘露薇	stars
吕行	stars
吕佳容	stars
吕丽萍	stars
吕良伟	stars
吕敏	stars
吕颂贤	stars
吕夏	stars
吕一	stars
吕逸涛	stars
吕珍九	stars
呂慧儀	stars
呂詩怡	stars
马灿灿	stars
马楚成	stars
马贯东	stars
马浩博	stars
马景涛	stars
马敬涵	stars
马浚伟	stars
马可	stars
马里奥毛瑞尔	stars
马丽	stars
马羚	stars
马启光	stars
马睿菈	stars
马赛	stars
马上又	stars
马思纯	stars
马苏	stars
马蹄露	stars
马天宇	stars
马薇薇	stars
马晓灿	stars
马星	stars
马雪阳	stars
马雅舒	stars
马伊琍	stars
马浴柯	stars
马志海	stars
马梓涵	stars
馬貫東	stars
馬浚偉	stars
馬賽	stars
馬蹄露	stars
馬天宇	stars
麦兆辉	stars
麦振鸿	stars
满江	stars
满文军	stars
毛阿敏	stars
毛俊杰	stars
毛林林	stars
毛毛虫	stars
毛宁	stars
毛舜筠	stars
毛晓彤	stars
茅子俊	stars
梅俪儿	stars
梅田彩佳	stars
梅婷	stars
梅艳芳	stars
媚眼天使SARA	stars
蒙古族歌手格格	stars
孟非	stars
孟京辉	stars
孟茜	stars
孟十朵	stars
孟庭苇	stars
孟小发	stars
孟瑶	stars
孟召重	stars
咪Mia	stars
米可儿	stars
米娜	stars
米雪	stars
苗圃	stars
闵天浩	stars
明道	stars
缪杰	stars
莫寒	stars
莫龙丹	stars
莫少聪	stars
莫文蔚	stars
莫小棋	stars
墨明棋妙	stars
牟星	stars
沐奕杉	stars
慕琦	stars
慕容晓晓	stars
穆婷婷	stars
那英	stars
娜蒂-阿根廷NATI	stars
娜扎	stars
南派三叔	stars
南拳媽媽-宇豪	stars
南笙	stars
妮可基德曼	stars
妮娜杜波夫	stars
尼格买提	stars
尼坤	stars
倪安东	stars
倪安東	stars
倪虹洁	stars
倪景阳	stars
倪妮	stars
倪子鱼	stars
鸟叔	stars
聂远	stars
宁财神	stars
宁丹琳	stars
宁浩	stars
宁桓宇	stars
宁静	stars
牛东文	stars
牛骏峰	stars
牛莉	stars
牛萌萌	stars
牛奶咖啡组合	stars
钮承泽	stars
鈕承澤	stars
农夫组合	stars
農夫Fama	stars
努力努力再努力x	stars
欧弟	stars
欧豪	stars
欧倩怡	stars
欧阳娣娣	stars
欧阳靖	stars
欧阳娜娜	stars
欧阳妮妮	stars
欧阳羽臣	stars
欧阳震华	stars
欧阳智薇	stars
歐陽娣娣	stars
歐陽靖	stars
歐陽娜娜	stars
歐陽妮妮	stars
潘安子	stars
潘斌龙	stars
潘辰	stars
潘慧如	stars
潘泰名	stars
潘玮柏	stars
潘瑋柏	stars
潘阳	stars
潘仪君	stars
潘儀君	stars
潘粤明	stars
潘长江	stars
潘之琳	stars
庞龙	stars
裴涩琪	stars
彭丹	stars
彭冠英	stars
彭海桐	stars
彭浩翔	stars
彭佳慧	stars
彭清	stars
彭杨	stars
彭于晏	stars
品冠	stars
蒲巴甲	stars
濮存昕	stars
朴灿烈	stars
朴恩惠	stars
朴海镇	stars
朴炯植	stars
朴敏英	stars
朴瑟	stars
朴山多拉	stars
朴施厚	stars
朴树	stars
朴信惠	stars
朴有天	stars
朴宥拉	stars
朴宰范	stars
朴振荣	stars
戚薇	stars
齐峰	stars
齐奎	stars
齐秦	stars
齐溪	stars
奇道	stars
奇然	stars
琦琦	stars
钱蓓婷	stars
钱枫	stars
钱嘉乐	stars
钱璇	stars
钱泳辰	stars
钱志君	stars
錢嘉樂	stars
乔乔	stars
乔任梁	stars
乔杉	stars
乔振宇	stars
秦戈	stars
秦海璐	stars
秦昊	stars
秦俊杰	stars
秦岚	stars
秦丽	stars
秦子越	stars
邱心志	stars
邱欣怡	stars
邱翊橙	stars
邱泽	stars
秋瓷炫	stars
秋元才加	stars
屈菁菁	stars
瞿颖	stars
曲高位	stars
曲泉丞	stars
曲婉婷	stars
权相佑	stars
权志龙	stars
全智贤	stars
冉倩	stars
冉旭	stars
饶威	stars
饶雪漫	stars
热依扎	stars
任程伟	stars
任达华	stars
任達華	stars
任东霖	stars
任晗	stars
任家萱	stars
任柯诺	stars
任路加	stars
任泉	stars
任时完	stars
任天野	stars
任曦	stars
任贤齐	stars
任言恺	stars
任重	stars
肜耀忠	stars
容祖儿	stars
阮经天	stars
阮經天	stars
瑞彦迷嘉尔	stars
撒贝宁	stars
萨顶顶	stars
萨仁高娃	stars
萨日娜	stars
赛琳娜Selina	stars
赛琳娜戈麦斯	stars
三浦春马	stars
沙宝亮	stars
沙溢	stars
莎莎于	stars
杉原杏璃	stars
商东茜	stars
商東茜	stars
商侃	stars
尚格云顿	stars
尚雯婕	stars
邵兵	stars
邵峰	stars
邵路雅	stars
邵小珊	stars
邵庄	stars
佘诗曼	stars
申奥	stars
沈傲君	stars
沈春阳	stars
沈丹萍	stars
沈佳妮	stars
沈肯尼	stars
沈黎晖	stars
沈凌	stars
沈梦辰	stars
沈薇	stars
沈晓海	stars
沈星	stars
沈震軒	stars
沈卓盈	stars
胜利	stars
盛一伦	stars
师洋	stars
施南生	stars
施诗	stars
施耀宗	stars
施予斐	stars
十一郎	stars
石筱群	stars
史俊威	stars
矢野浩二	stars
释行宇	stars
释小龙	stars
舒畅	stars
舒冬	stars
舒乐嘎	stars
舒淇	stars
水均益	stars
水木年华	stars
水咲萝拉	stars
水原希子	stars
司徒烨羽	stars
斯琴高丽	stars
斯琴高娃	stars
宋秉洋	stars
宋春丽	stars
宋丹丹	stars
宋冬野	stars
宋飞	stars
宋佳	stars
宋佳伦	stars
宋茜	stars
宋小宝	stars
宋晓峰	stars
宋洋	stars
宋伊人	stars
宋轶	stars
宋允皓	stars
宋再临	stars
宋再臨	stars
宋智孝	stars
宋祖儿	stars
苏打绿	stars
苏丁琦	stars
苏慧伦	stars
苏见信	stars
苏芒	stars
苏梦玫	stars
苏倩薇	stars
苏晴	stars
苏醒	stars
苏彦洁	stars
苏有朋	stars
苏志燮	stars
苏梓玲	stars
蘇打綠Sodagreen	stars
蘇打綠阿福	stars
蘇打綠阿龔	stars
蘇打綠小威	stars
蘇打綠馨儀	stars
蘇慧倫	stars
蘇有朋	stars
隋俊波	stars
隋凯	stars
隋棠	stars
隋咏良	stars
孙淳	stars
孙淡妃	stars
孙东云	stars
孙菲菲	stars
孙海英	stars
孙浩	stars
孙皓	stars
孙红雷	stars
孙洪涛	stars
孙佳奇	stars
孙嘉	stars
孙嘉一	stars
孙坚	stars
孙建弘	stars
孙俪	stars
孙莉	stars
孙楠	stars
孙宁	stars
孙茜	stars
孙清	stars
孙睿	stars
孙绍龙	stars
孙树培	stars
孙文婷	stars
孙熙	stars
孙骁骁	stars
孙雅	stars
孙耀威	stars
孙艺珍	stars
孙艺洲	stars
孙悦	stars
孙自佑	stars
孫樹培	stars
孫耀威	stars
孫自佑	stars
邰上黄	stars
邰上黃	stars
邰正宵	stars
泰勒斯威夫特	stars
谈莉娜	stars
谭盾	stars
谭乔	stars
谭松韵	stars
谭维维	stars
谭歆柔	stars
谭耀文	stars
谭咏麟	stars
檀健次	stars
檀烧	stars
譚耀文	stars
汤宝如	stars
汤灿	stars
汤加丽	stars
汤晶媚	stars
汤俊业	stars
汤洛雯	stars
汤姆·克鲁斯	stars
汤姆克鲁斯	stars
汤姆提克威	stars
汤唯	stars
汤怡	stars
汤盈盈	stars
汤镇业	stars
汤镇宗	stars
汤子英	stars
湯洛雯	stars
湯怡	stars
湯盈盈	stars
湯鎮宗	stars
唐国强	stars
唐诗咏	stars
唐熙	stars
唐笑笑	stars
唐嫣	stars
唐一菲	stars
唐艺昕	stars
唐于鸿	stars
唐禹哲	stars
唐志中	stars
陶红	stars
陶虹	stars
陶慧	stars
陶晶莹	stars
陶帥	stars
陶思源	stars
陶冶	stars
陶喆	stars
腾格尔	stars
滕华涛	stars
滕丽名	stars
滕文骥	stars
天下霸唱	stars
田馥甄	stars
田海蓉	stars
田蕾希	stars
田丽	stars
田亮	stars
田梅	stars
田牧宸	stars
田朴珺	stars
田喜碧Hebe	stars
田艺苗	stars
田翌臣	stars
田原	stars
田震	stars
田子田	stars
恬妞	stars
庭萱	stars
佟大为	stars
佟丽娅	stars
童菲	stars
童蕾	stars
童瑶	stars
涂黎曼	stars
涂世旻	stars
涂松岩	stars
屠洪刚	stars
万国鹏	stars
万弘杰	stars
万美汐	stars
万妮恩	stars
万茜	stars
万翔	stars
万晓利	stars
萬綺雯	stars
萬曉利	stars
汪东城	stars
汪峰	stars
汪涵	stars
汪明荃	stars
汪裴	stars
汪苏泷	stars
汪小敏	stars
王安迪	stars
王斑	stars
王宝强	stars
王碧儿	stars
王博轼	stars
王博文	stars
王传君	stars
王传一	stars
王聪	stars
王大陆	stars
王大治	stars
王笛	stars
王菲	stars
王菲菲	stars
王霏霏	stars
王海祥	stars
王浩钧	stars
王浩信	stars
王姬	stars
王家卫	stars
王嘉诚	stars
王建福	stars
王杰	stars
王洁实	stars
王劲松	stars
王晶	stars
王靖雯	stars
王靖云	stars
王静	stars
王静大美	stars
王君馨	stars
王俊凯	stars
王凯	stars
王珂	stars
王乐君	stars
王雷	stars
王黎光	stars
王李丹妮	stars
王力宏	stars
王力可	stars
王丽坤	stars
王丽萍	stars
王琳	stars
王龙华	stars
王珞丹	stars
王梦婷	stars
王宁	stars
王鸥	stars
王盼盼	stars
王平久	stars
王千源	stars
王茜	stars
王青	stars
王秋紫	stars
王仁君	stars
王若心	stars
王莎莎	stars
王少雍	stars
王诗龄	stars
王双	stars
王思聪	stars
王思思	stars
王思雅	stars
王思懿	stars
王弢	stars
王天野	stars
王汀	stars
王彤	stars
王婉晨	stars
王婉中	stars
王伟	stars
王文博	stars
王喜	stars
王小虎	stars
王小利	stars
王小帅	stars
王小玮	stars
王晓	stars
王晓晨	stars
王晓彤	stars
王啸坤	stars
王心凌	stars
王新	stars
王馨平	stars
王学兵	stars
王学好	stars
王学圻	stars
王迅	stars
王雅捷	stars
王雅君	stars
王亚彬	stars
王亚楠	stars
王彦霖	stars
王艳	stars
王阳明	stars
王洋	stars
王陽明	stars
王业	stars
王一博	stars
王以纶	stars
王艺禅	stars
王译锋	stars
王滢	stars
王媛可	stars
王源	stars
王岳伦	stars
王长田	stars
王铮	stars
王铮亮	stars
王筝	stars
王志飞	stars
王智	stars
王中军	stars
王中磊	stars
王子	stars
王子文	stars
王梓轩	stars
王梓軒	stars
王祖蓝	stars
王祖藍	stars
威威陳威翰	stars
薇薇安沈	stars
巍子	stars
韦礼安	stars
韦雄	stars
韋禮安	stars
维塔斯	stars
卫兰	stars
卫诗雅	stars
魏晨	stars
魏大勋	stars
魏佳庆	stars
魏千翔	stars
魏如萱	stars
魏一宁	stars
温碧霞	stars
温岚	stars
温尚翊	stars
温升豪	stars
温兆伦	stars
文静	stars
文隽	stars
文梦洋	stars
文茜	stars
文颂娴	stars
文章	stars
文章同學	stars
文卓	stars
翁虹	stars
我系彭彭	stars
邬君梅	stars
邬立朋	stars
吴斌	stars
吴辰君	stars
吴刚	stars
吴昊泽	stars
吴赫	stars
吴弘	stars
吴虹飞	stars
吴家乐	stars
吴建飞	stars
吴京	stars
吴君如	stars
吴克清	stars
吴磊	stars
吴孟达	stars
吴玟萱	stars
吴莫愁	stars
吴念真	stars
吴佩慈	stars
吴奇隆	stars
吴启华	stars
吴绮莉	stars
吴千语	stars
吴倩	stars
吴青峰	stars
吴若甫	stars
吴世勋	stars
吴思凡	stars
吴彤	stars
吴晓敏	stars
吴昕	stars
吴秀波	stars
吴彦祖	stars
吴亦凡	stars
吴映洁	stars
吴宇森	stars
吴雨	stars
吴樾	stars
吴昀廷	stars
吴哲晗	stars
吴镇宇	stars
吴志雄	stars
吴卓羲	stars
吴子牛	stars
吴宗宪	stars
吳家樂	stars
吳京	stars
吳君如	stars
吳玟萱	stars
吳念真	stars
吳千語	stars
吳青峰	stars
吳彥祖	stars
吳雨	stars
吳卓羲	stars
五月天頑石	stars
伍佰	stars
伍佳丽	stars
伍思凯	stars
伍咏薇	stars
伍詠薇	stars
伍宇娟	stars
武艺	stars
西城男孩	stars
希天才	stars
希亚	stars
奚美娟	stars
奚望	stars
奚仲文	stars
稀土部队	stars
夏凡	stars
夏奇拉	stars
夏天Poppy	stars
夏尉喻	stars
夏文汐	stars
夏永康	stars
夏雨	stars
夏志远	stars
夏梓桐	stars
先艺	stars
弦子	stars
冼灏英	stars
向辰	stars
向华强	stars
向华胜	stars
向華強	stars
向太Tiffany陳嵐	stars
向佐	stars
肖飞	stars
肖捷	stars
肖旭	stars
肖茵	stars
萧定一	stars
萧煌奇	stars
萧敬腾	stars
萧淑慎	stars
萧亚轩	stars
萧正楠	stars
蕭敬騰	stars
小S	stars
小彩旗	stars
小虫	stars
小蟲本尊	stars
小嶋陽菜	stars
小娟与山谷里的居民	stars
小俊先生	stars
小李琳	stars
小栗旬	stars
小林香菜	stars
小刘哥	stars
小罗伯特唐尼	stars
小沈阳	stars
小陶虹	stars
小野丽莎	stars
晓微	stars
篠田麻里子	stars
孝敏	stars
孝渊	stars
谢安琪	stars
谢彬彬	stars
谢波	stars
谢君豪	stars
谢坤达	stars
谢孟伟	stars
谢苗	stars
谢娜	stars
谢楠	stars
谢天华	stars
谢天笑	stars
谢婷婷	stars
谢霆锋	stars
谢贤	stars
谢小志	stars
谢馨仪	stars
谢依霖	stars
謝坤達	stars
謝天華	stars
謝婷婷	stars
辛柏青	stars
辛龍	stars
辛晓琪	stars
辛曉琪	stars
辛雨锡	stars
新七小福	stars
信shin8989	stars
邢宇菲	stars
邢昭林	stars
熊彬翔	stars
熊黛林	stars
熊乃瑾	stars
修杰楷	stars
修侃	stars
修睿	stars
徐百卉	stars
徐晨辰	stars
徐彳余	stars
徐丹	stars
徐冬梅	stars
徐峰柏	stars
徐海乔	stars
徐濠萦	stars
徐濠縈	stars
徐浩	stars
徐颢菲	stars
徐怀钰	stars
徐黄丽	stars
徐佳	stars
徐佳莹	stars
徐佳瑩	stars
徐娇	stars
徐洁儿	stars
徐锦江	stars
徐静蕾	stars
徐筠	stars
徐开骋	stars
徐可	stars
徐克	stars
徐璐	stars
徐露	stars
徐千雅	stars
徐睿	stars
徐若瑄	stars
徐杉	stars
徐婷	stars
徐熙娣	stars
徐熙颜	stars
徐熙媛	stars
徐玺涵	stars
徐小可	stars
徐小明	stars
徐小婷	stars
徐玄	stars
徐杨	stars
徐誉滕	stars
徐峥	stars
徐正曦	stars
徐子菲	stars
许鞍华	stars
许常德	stars
许诚毅	stars
许飞	stars
许歌	stars
许慧欣	stars
许佳琪	stars
许建强	stars
许明虎	stars
许晴	stars
许茹芸	stars
许嵩	stars
许添	stars
许廷铿	stars
许魏洲	stars
许文广	stars
许毓娟	stars
许云皓	stars
许哲佩	stars
许志安	stars
旭日阳刚刘刚	stars
宣璐	stars
宣萱	stars
宣言	stars
薛飞	stars
薛佳凝	stars
薛凯琪	stars
薛晓路	stars
薛之谦	stars
雅尼	stars
亚当兰伯特	stars
闫妮	stars
闫鑫泷	stars
严歌苓	stars
严爵	stars
严励行	stars
严少辰	stars
严屹宽	stars
言承旭	stars
岩井俊二	stars
炎亚纶	stars
阎娜	stars
阎学晶	stars
颜丙燕	stars
颜楚杉	stars
颜丹晨	stars
颜玺轩	stars
颜卓灵	stars
嚴爵	stars
扬帆	stars
阳羽臣	stars
杨爱瑾	stars
杨冰	stars
杨采妮	stars
杨丞琳	stars
杨帆	stars
杨恭如	stars
杨浩煜	stars
杨洪基	stars
杨俊杰	stars
杨坤	stars
杨澜	stars
杨丽菁	stars
杨幂	stars
杨明娜	stars
杨乃文	stars
杨培安	stars
杨奇鸣	stars
杨奇煜	stars
杨千嬅	stars
杨蓉	stars
杨若兮	stars
杨森	stars
杨石头	stars
杨受成	stars
杨舒	stars
杨舒婷	stars
杨树林	stars
杨思琦	stars
杨涛	stars
杨童舒	stars
杨小蕊	stars
杨小舒舒	stars
杨秀惠	stars
杨雪	stars
杨洋	stars
杨怡	stars
杨颖	stars
杨永聪	stars
杨祐宁	stars
杨雨婷	stars
杨钰莹	stars
杨云阁	stars
杨政	stars
杨志刚	stars
杨子	stars
杨子姗	stars
杨梓文祺	stars
杨紫	stars
杨紫琼	stars
杨紫嫣	stars
杨宗纬	stars
楊愛瑾	stars
楊丞琳	stars
楊培安	stars
楊千嬅	stars
楊思琦	stars
楊秀惠	stars
楊怡	stars
楊永聰	stars
楊祐寧	stars
楊渝渝	stars
尧十三	stars
尧小厨	stars
姚贝娜	stars
姚晨	stars
姚笛	stars
姚芊羽	stars
姚星彤	stars
姚星竹	stars
姚奕辰	stars
姚雨鑫	stars
姚元浩	stars
姚中仁	stars
姚子羚	stars
叶蓓	stars
叶禾	stars
叶锦添	stars
叶静	stars
叶念琛	stars
叶晴晴	stars
叶世荣	stars
叶伟民	stars
叶伟信	stars
叶相明	stars
叶璇	stars
叶一茜	stars
葉念琛	stars
葉晴晴	stars
葉世榮	stars
葉偉信	stars
伊恩萨默海尔德	stars
伊琍爸爸	stars
伊能静	stars
伊能靜	stars
伊一	stars
艺人红孩	stars
艺声	stars
亦舒	stars
易烊千玺	stars
奕彤	stars
殷宝莹	stars
殷桃	stars
殷旭	stars
银赫	stars
尹斗俊	stars
尹航	stars
尹施允	stars
尹天照	stars
尹相铉	stars
尹正	stars
尹子維	stars
印小天	stars
英达	stars
瑛子	stars
颖儿	stars
应采儿	stars
咏梅	stars
尤浩然	stars
尤勇	stars
游鸿明	stars
游艺湉	stars
友田彩也香	stars
宥胜	stars
于白水	stars
于波	stars
于果	stars
于和伟	stars
于朦胧	stars
于明加	stars
于沛	stars
于青斌	stars
于莎莎	stars
于湉	stars
于象	stars
于小磊	stars
于小彤	stars
于小伟	stars
于洋	stars
于咏琳	stars
于月仙	stars
于越	stars
于震	stars
余安安	stars
余超颖	stars
余铭轩	stars
余男	stars
余文乐	stars
余文樂	stars
余心恬	stars
余致纬	stars
俞承豪	stars
俞飞鸿	stars
俞灏明	stars
俞利	stars
宇珊	stars
宇桐非	stars
宇宙少女	stars
羽泉	stars
雨僑	stars
禹童	stars
庾澄庆	stars
庾澄慶	stars
玉泽演	stars
郁可唯	stars
喻恩泰	stars
喻佳丽	stars
元彪	stars
元彬	stars
元德	stars
元华	stars
元奎	stars
元秋	stars
袁成杰	stars
袁菲	stars
袁和平	stars
袁弘	stars
袁立	stars
袁伶嫣	stars
袁泉	stars
袁姗姗	stars
袁帅	stars
袁惟仁	stars
袁伟豪	stars
袁文康	stars
袁咏琳	stars
袁咏仪	stars
袁云才	stars
袁志博	stars
苑琼丹	stars
苑新雨	stars
岳丽娜	stars
岳云鹏	stars
樂瞳	stars
臧洪娜	stars
臧金生	stars
臧天朔	stars
扎西顿珠	stars
翟天临	stars
翟子陌	stars
詹雯婷	stars
詹宇豪	stars
战菁一	stars
张艾嘉	stars
张柏嘉	stars
张柏芝	stars
张本渝	stars
张彬彬	stars
张琛	stars
张晨光	stars
张楚楚	stars
张达明	stars
张迪	stars
张定涵	stars
张栋梁	stars
张铎	stars
张恩齐	stars
张丰毅	stars
张根硕	stars
张国立	stars
张国强	stars
张含韵	stars
张涵予	stars
张翰	stars
张行	stars
张浩然	stars
张皓明	stars
张皓然	stars
张恒	stars
张洪睿	stars
张华敏	stars
张惠春	stars
张惠妹	stars
张惠雅	stars
张慧雯	stars
张佳宁	stars
张家辉	stars
张嘉兒	stars
张嘉倪	stars
张嘉佑	stars
张坚庭	stars
张杰	stars
张晋	stars
张敬轩	stars
张静初	stars
张钧涵	stars
张钧甯	stars
张俊以	stars
张峻豪	stars
张蓝心	stars
张澜澜	stars
张磊	stars
张俪	stars
张栗维	stars
张亮	stars
张靓颖	stars
张陆	stars
张伦硕	stars
张曼玉	stars
张萌	stars
张檬	stars
张明明	stars
张默	stars
张娜拉	stars
张暖雅	stars
张茜	stars
张倩如	stars
张瑞希	stars
张若昀	stars
张珊萌	stars
张韶涵	stars
张少博	stars
张少华	stars
张颂文	stars
张腾岳	stars
张天爱	stars
张天其	stars
张庭	stars
张彤	stars
张卫健	stars
张文慈	stars
张纹嘉	stars
张曦文	stars
张骁俨	stars
张小斐	stars
张晓晨	stars
张晓磊	stars
张晓龙	stars
张筱婕	stars
张辛苑	stars
张歆怡	stars
张歆艺	stars
张馨予	stars
张鑫	stars
张信哲	stars
张学友	stars
张雪迎	stars
张雅萌	stars
张亚希	stars
张棪琰	stars
张燕	stars
张燕峰	stars
张燕妮	stars
张扬	stars
张瑶	stars
张一山	stars
张洢萌	stars
张艺騫	stars
张艺谋	stars
张艺兴	stars
张译	stars
张译木	stars
张逸杰	stars
张祐荣	stars
张予曦	stars
张宇	stars
张雨绮	stars
张语格	stars
张玉安	stars
张钰琪	stars
张元	stars
张远	stars
张悦轩	stars
张芸京	stars
张兆辉	stars
张哲瀚	stars
张振宇	stars
张震	stars
张震岳	stars
张致恒	stars
张智成	stars
张智霖	stars
张智尧	stars
张洲	stars
张卓楠	stars
张子枫	stars
张子文	stars
张子萱	stars
张梓琳	stars
张梓淇	stars
章含之	stars
章龄之	stars
章婷婷	stars
章泽天	stars
章子怡	stars
張本渝	stars
張達明	stars
張國強	stars
張皓明	stars
張惠春	stars
張惠雅	stars
張嘉兒	stars
張敬軒	stars
張鈞甯	stars
張甯兒	stars
張睿家	stars
張文慈	stars
張紋嘉	stars
張曉晨	stars
張信哲	stars
張懸	stars
張宇	stars
張兆輝	stars
張震	stars
張震嶽	stars
張致恒	stars
張智霖	stars
張卓楠	stars
长谷真理香	stars
赵宝刚	stars
赵本山	stars
赵滨	stars
赵晨阳	stars
赵传	stars
赵达	stars
赵丹	stars
赵恩世	stars
赵虹	stars
赵慧仙	stars
赵嘉敏	stars
赵久毅	stars
赵浚承	stars
赵柯	stars
赵丽蓉	stars
赵丽颖	stars
赵敏成	stars
赵鹏	stars
赵普	stars
赵茜	stars
赵仕瑾	stars
赵涛	stars
赵薇	stars
赵文浩	stars
赵文瑄	stars
赵文卓	stars
赵晓好	stars
赵雅芝	stars
赵阳	stars
赵奕欢	stars
赵毅	stars
赵咏华	stars
赵泳鑫	stars
赵又廷	stars
赵圆瑗	stars
赵子惠	stars
赵子琪	stars
趙詠華	stars
趙又廷	stars
甄子丹	stars
鎮宇DD的豬頭俱樂部	stars
郑保瑞	stars
郑淳元	stars
郑凡	stars
郑国霖	stars
郑嘉嘉	stars
郑嘉颖	stars
郑敬淏	stars
郑钧	stars
郑凯	stars
郑恺	stars
郑罗茜	stars
郑佩佩	stars
郑容和	stars
郑绍康	stars
郑舒尹	stars
郑爽	stars
郑希怡	stars
郑小瑛	stars
郑秀文	stars
郑秀妍	stars
郑业成	stars
郑伊健	stars
郑亦桐	stars
郑裕玲	stars
郑渊洁	stars
郑元畅	stars
郑媛元	stars
郑则仕	stars
郑智薰	stars
郑中基	stars
鄭嘉嘉	stars
鄭嘉穎	stars
鄭紹康	stars
鄭舒尹	stars
鄭伊健	stars
鄭裕玲	stars
鄭中基	stars
至上励合刘洲成	stars
至上励合张远	stars
智妍	stars
中孝介	stars
钟楚红	stars
钟汉良	stars
钟嘉欣	stars
钟丽缇	stars
钟舒漫	stars
钟舒祺	stars
钟欣凌	stars
钟欣桐	stars
钟一宪	stars
钟镇涛	stars
鍾嘉欣	stars
鍾舒漫	stars
鍾舒祺	stars
鍾欣凌	stars
鍾欣潼	stars
种丹妮	stars
周柏豪	stars
周笔畅	stars
周楚楚	stars
周传雄	stars
周傳雄	stars
周冬齐	stars
周冬雨	stars
周国贤	stars
周國賢	stars
周海媚	stars
周蕙	stars
周家怡	stars
周杰	stars
周杰伦	stars
周丽淇	stars
周美欣	stars
周牧茵	stars
周奇奇	stars
周润发	stars
周汤豪	stars
周晓涵	stars
周晓鸥	stars
周星驰	stars
周迅	stars
周艳泓	stars
周扬	stars
周宜霈	stars
周弋楠	stars
周艺轩	stars
周毅	stars
周渝民	stars
周雨彤	stars
周元	stars
周云蓬	stars
周知	stars
周子扬	stars
朱晨丽	stars
朱晨麗	stars
朱丹	stars
朱丹青	stars
朱刚日尧	stars
朱宏嘉	stars
朱虹	stars
朱慧敏	stars
朱杰	stars
朱洁静	stars
朱凯婷	stars
朱克	stars
朱千雪	stars
朱锐	stars
朱圣祎	stars
朱时茂	stars
朱铁	stars
朱婷	stars
朱文超	stars
朱孝天	stars
朱迅	stars
朱亚文	stars
朱一龙	stars
朱奕静	stars
朱泳腾	stars
朱雨辰	stars
朱元冰	stars
朱媛媛	stars
朱哲琴	stars
朱珠	stars
庄濠全	stars
庄思敏	stars
庄思明	stars
庄严	stars
卓文萱	stars
卓韵芝	stars
子墨_布拉德皮蛋	stars
子韬爸爸	stars
子夜lisa	stars
邹东孝	stars
邹晶晶	stars
邹静之	stars
邹市明	stars
邹廷威	stars
祖峰	stars
祖海	stars
左小青	stars
左小祖咒	stars
左溢	stars
佐藤健	stars